N0,N1,N2,Volume,Enclosing_surface,Contact_surface,TETRAVOXEL,OCTOVOXEL,MISC_Async
5298,9103,5141,957,4540,601,23,0,379.0
5325,14396,11513,2843,5968,5545,2460,159,-401.0
4950,14210,12452,3381,4618,7834,4974,710,-189.0
6318,12511,7888,1606,6140,1748,231,0,89.0
5742,14373,10777,2521,6428,4349,1517,64,-375.0
4859,14018,12737,3626,3718,9019,6582,1237,-48.0
6092,11782,7308,1470,5796,1512,190,0,148.0
6197,14143,9910,2196,6644,3266,855,17,-232.0
5871,14349,10621,2466,6446,4175,1457,71,-323.0
5695,10314,6081,1174,5118,963,78,1,288.0
5728,10258,5991,1147,5100,891,58,0,314.0
5912,14195,10328,2359,6502,3826,1191,38,-314.0
6245,12554,8011,1648,6134,1877,286,3,54.0
4895,13955,12860,3775,3070,9790,7815,1775,25.0
5646,10149,5943,1140,5046,897,57,0,300.0
5149,14391,11989,3084,5474,6515,3443,349,-337.0
2488,3900,2034,353,1950,84,0,0,269.0
5058,8711,4929,919,4344,585,23,0,357.0
5059,14307,12092,3153,5266,6826,3775,411,-309.0
3268,5208,2759,486,2602,157,4,0,333.0
608,920,464,78,460,4,0,0,74.0
6100,14261,10196,2299,6598,3598,1065,30,-264.0
6145,14110,9944,2216,6592,3352,926,27,-237.0
3460,5590,2998,534,2792,206,6,0,334.0
6380,12657,8001,1634,6198,1803,261,2,90.0
6147,13930,9715,2146,6554,3161,822,21,-214.0
6311,13371,8874,1884,6444,2430,483,7,-70.0
6043,14021,9975,2242,6498,3477,1025,35,-245.0
5156,14366,11981,3086,5446,6535,3474,340,-315.0
2604,4084,2131,370,2042,89,0,0,281.0
6362,13568,9017,1912,6562,2455,444,2,-101.0
5446,9605,5545,1052,4778,767,49,0,334.0
2192,3380,1736,297,1690,46,0,0,251.0
5372,14446,11656,2917,5810,5846,2826,232,-335.0
4967,14174,12384,3359,4614,7770,4946,717,-182.0
4891,13971,12867,3764,3150,9717,7671,1695,23.0
6214,12050,7493,1511,5920,1573,210,2,146.0
6214,11999,7446,1500,5892,1554,215,0,161.0
4878,14028,12651,3567,3900,8751,6228,1110,-66.0
6054,11225,6743,1322,5554,1189,117,0,250.0
5508,9732,5629,1070,4838,791,56,0,335.0
4922,14127,12493,3436,4370,8123,5387,848,-148.0
6149,13740,9471,2070,6522,2949,696,7,-190.0
5290,9241,5294,998,4600,694,41,0,345.0
6219,13314,8885,1892,6418,2467,478,5,-102.0
5426,9391,5339,1000,4678,661,35,0,374.0
4890,14090,12710,3582,3928,8782,6234,1106,-72.0
2312,3644,1910,333,1822,88,0,0,245.0
4933,14200,12409,3354,4694,7715,4812,663,-212.0
5283,14432,11670,2911,5874,5796,2684,189,-390.0
6090,11647,7159,1429,5744,1415,159,0,173.0
6271,12781,8240,1709,6226,2014,329,3,21.0
5793,14459,10802,2519,6490,4312,1479,69,-383.0
6055,14125,10059,2258,6570,3489,985,23,-269.0
6088,11454,6953,1374,5662,1291,130,0,213.0
4891,14110,12524,3454,4324,8200,5462,865,-149.0
5902,10787,6404,1243,5350,1054,87,0,276.0
6143,11542,7013,1389,5692,1321,158,1,225.0
6154,13566,9270,2014,6456,2814,654,10,-156.0
4901,13888,13003,3967,2204,10799,9480,2599,49.0
5878,11103,6752,1335,5494,1258,115,0,192.0
6240,12416,7852,1602,6092,1760,232,0,74.0
4885,13913,12927,3849,2760,10167,8393,2025,50.0
312,472,238,40,236,2,0,0,38.0
4900,14162,12482,3409,4510,7972,5142,768,-189.0
6172,14033,9811,2171,6596,3215,841,18,-221.0
4670,7871,4376,804,3928,448,15,0,371.0
5830,14140,10351,2375,6452,3899,1236,46,-334.0
5016,8478,4723,869,4232,491,14,0,392.0
4972,14221,12415,3364,4646,7769,4929,722,-198.0
5316,14473,11728,2938,5828,5900,2817,222,-367.0
5705,14207,10635,2487,6348,4287,1511,65,-354.0
3730,5975,3179,562,2986,193,3,0,372.0
6304,12002,7349,1462,5926,1423,150,0,189.0
6381,13611,9037,1914,6590,2447,431,5,-107.0
5760,14375,10761,2515,6432,4329,1511,66,-369.0
5140,14357,12001,3100,5402,6599,3553,370,-316.0
6291,13491,9063,1946,6450,2613,591,7,-83.0
4922,14112,12546,3473,4254,8292,5604,902,-117.0
2818,4429,2316,403,2214,102,1,0,302.0
6255,12664,8149,1691,6152,1997,360,5,49.0
1544,2380,1222,209,1190,32,0,0,177.0
6178,13576,9249,2005,6468,2781,640,18,-154.0
6136,11184,6624,1283,5550,1074,84,0,293.0
6224,11867,7285,1454,5846,1439,175,2,188.0
6354,12334,7674,1548,6060,1614,214,2,146.0
6178,11929,7390,1485,5870,1520,189,0,154.0
6249,13786,9441,2057,6540,2901,706,15,-153.0
4336,7296,4050,743,3642,408,12,0,347.0
6075,11526,7036,1396,5696,1340,134,1,189.0
5776,14255,10612,2472,6392,4220,1471,62,-339.0
6229,12735,8234,1712,6196,2038,343,1,16.0
6151,13211,8840,1887,6358,2482,495,7,-107.0
4895,13946,12894,3811,2922,9972,8102,1909,32.0
4964,14219,12443,3378,4618,7825,4983,726,-190.0
6147,12319,7856,1617,6010,1846,299,3,67.0
5697,14109,10543,2464,6302,4241,1505,61,-333.0
1312,1996,1012,171,998,14,0,0,157.0
5768,10484,6202,1201,5198,1004,88,0,285.0
4890,14010,12768,3669,3522,9246,6966,1410,-21.0
6085,14045,9900,2202,6588,3312,869,21,-262.0
5344,14438,11598,2882,5904,5694,2630,196,-378.0
4358,7189,3923,709,3592,331,5,0,383.0
5969,13980,9940,2225,6530,3410,920,31,-296.0
4296,7084,3866,699,3538,328,8,0,379.0
5093,14289,12097,3169,5180,6917,3929,449,-268.0
3934,6459,3510,632,3228,282,3,0,353.0
4974,14224,12438,3372,4644,7794,4936,698,-184.0
6256,12529,7986,1643,6114,1872,301,2,70.0
6323,12995,8444,1764,6304,2140,387,3,8.0
5579,14444,11151,2676,6246,4905,1952,113,-390.0
6268,13726,9295,2000,6590,2705,546,4,-163.0
6311,13340,8837,1873,6436,2401,468,5,-65.0
5072,14276,12117,3183,5136,6981,4004,476,-270.0
6125,13921,9704,2139,6574,3130,773,13,-231.0
5126,14328,11980,3096,5384,6596,3560,378,-318.0
6150,12344,7850,1608,6052,1798,240,2,48.0
5328,14438,11625,2895,5880,5745,2678,208,-380.0
6298,12931,8397,1754,6270,2127,391,8,10.0
5051,14254,12100,3176,5144,6956,3966,465,-279.0
5723,14297,10719,2509,6384,4335,1529,67,-364.0
6195,14102,9845,2173,6652,3193,798,13,-235.0
5981,11133,6703,1316,5510,1193,113,1,235.0
6179,13307,8966,1930,6352,2614,603,11,-92.0
5229,14400,11784,2980,5688,6096,3024,275,-367.0
6014,14261,10304,2344,6544,3760,1173,44,-287.0
5578,10049,5906,1138,4984,922,81,0,297.0
4881,13915,12870,3814,2856,10014,8203,1981,22.0
280,420,210,35,210,0,0,0,35.0
6138,13817,9581,2107,6520,3061,777,28,-205.0
6295,13841,9443,2050,6586,2857,669,15,-153.0
4871,14097,12619,3515,4148,8471,5801,967,-122.0
6245,13355,8908,1897,6434,2474,487,9,-99.0
6342,13191,8617,1804,6410,2207,371,4,-36.0
6208,11843,7259,1445,5848,1411,147,2,179.0
4953,14217,12460,3386,4604,7856,5009,729,-190.0
6254,12129,7539,1519,5964,1575,201,0,145.0
5548,9760,5627,1067,4852,775,56,0,348.0
5608,14419,11074,2648,6260,4814,1899,118,-385.0
556,836,419,70,418,1,0,0,69.0
5887,10702,6327,1224,5310,1017,82,1,288.0
5446,14469,11471,2823,6004,5467,2461,192,-375.0
6092,13661,9419,2058,6490,2929,681,18,-208.0
5516,9716,5603,1062,4834,769,48,0,341.0
304,460,232,39,230,2,0,0,37.0
4100,6720,3647,656,3358,289,4,0,371.0
6008,11343,6909,1370,5598,1311,147,2,204.0
4901,13951,12863,3784,3022,9841,7907,1821,29.0
4940,8316,4615,846,4154,461,8,0,393.0
6166,13512,9178,1983,6458,2720,596,10,-151.0
4912,13870,13034,4043,1810,11224,10250,3036,33.0
5894,14041,10200,2335,6390,3810,1261,68,-282.0
6182,13534,9185,1983,6472,2713,590,10,-150.0
6056,11290,6813,1341,5580,1233,130,0,238.0
6005,13500,9376,2066,6356,3020,788,19,-185.0
4899,13892,12968,3925,2386,10582,9120,2413,50.0
4940,14160,12510,3436,4404,8106,5352,828,-146.0
5330,9363,5393,1022,4654,739,55,0,338.0
4886,13938,12852,3778,3036,9816,7866,1806,22.0
4895,14006,12778,3677,3494,9284,7018,1421,-10.0
5647,14445,11072,2644,6280,4792,1885,107,-370.0
4881,13966,12841,3739,3248,9593,7470,1599,17.0
5641,14419,11033,2629,6292,4741,1835,97,-374.0
1672,2592,1338,230,1296,42,0,0,188.0
6203,11886,7328,1468,5848,1480,190,1,177.0
4889,14055,12675,3581,3864,8811,6327,1169,-72.0
6295,13331,8827,1869,6440,2387,451,11,-78.0
4845,13953,12801,3709,3348,9453,7257,1529,-16.0
6186,12045,7514,1519,5914,1600,217,0,136.0
6000,13739,9633,2134,6462,3171,815,18,-240.0
6074,13633,9469,2088,6410,3059,813,20,-178.0
5050,14300,12180,3206,5124,7056,4052,478,-276.0
6084,13987,9837,2185,6564,3273,859,22,-251.0
6216,12409,7882,1616,6068,1814,273,2,73.0
6227,12359,7804,1591,6062,1742,235,3,81.0
1732,2668,1369,234,1334,35,0,0,199.0
6306,13014,8457,1764,6330,2127,354,6,-15.0
4956,14181,12502,3428,4436,8066,5309,822,-151.0
5243,14406,11699,2931,5812,5887,2782,221,-395.0
6226,13406,9026,1941,6406,2620,594,10,-95.0
4674,7897,4398,809,3942,456,13,0,366.0
6290,13352,8891,1895,6412,2479,528,10,-66.0
6167,13608,9311,2026,6466,2845,676,13,-156.0
6308,13592,9124,1953,6530,2594,532,4,-113.0
6370,13024,8421,1751,6336,2085,352,2,16.0
4896,14002,12743,3652,3574,9169,6854,1352,-15.0
6226,11942,7368,1477,5874,1494,194,2,175.0
1160,1784,914,156,892,22,0,0,134.0
4911,13872,13028,4030,1876,11152,10120,2961,37.0
5950,11117,6705,1317,5508,1197,101,0,221.0
5993,14213,10232,2316,6568,3664,1077,33,-304.0
4892,14057,12692,3595,3814,8878,6429,1214,-68.0
440,668,338,57,334,4,0,0,53.0
4912,14097,12667,3562,3962,8705,6173,1110,-80.0
6382,13282,8697,1826,6438,2259,406,2,-29.0
5504,9966,5867,1130,4954,913,58,0,275.0
6201,12466,7950,1634,6096,1854,274,3,51.0
6303,13455,8983,1916,6470,2513,515,3,-85.0
4592,7594,4153,752,3794,359,6,0,399.0
4782,8067,4488,825,4026,462,15,0,378.0
5200,14339,11821,3014,5558,6263,3223,306,-332.0
5597,14346,11022,2639,6210,4812,1926,119,-366.0
6201,13264,8870,1896,6364,2506,536,15,-89.0
6350,13758,9271,1990,6602,2669,554,2,-127.0
6222,13746,9398,2042,6544,2854,658,14,-168.0
6101,14173,10074,2262,6576,3498,1021,45,-260.0
5773,14332,10684,2489,6434,4250,1464,67,-364.0
3230,5175,2754,487,2586,168,3,0,322.0
6180,12848,8376,1749,6258,2118,332,4,-41.0
5688,10134,5891,1123,5044,847,46,0,322.0
5799,10782,6491,1275,5332,1159,118,1,233.0
4914,13874,13049,4081,1612,11437,10650,3286,8.0
6163,13890,9645,2123,6552,3093,786,21,-205.0
5782,10719,6442,1264,5300,1142,119,0,241.0
6156,11963,7442,1500,5884,1558,195,2,135.0
2368,3696,1920,332,1848,72,0,0,260.0
6375,12422,7741,1562,6110,1631,202,1,132.0
6267,13976,9663,2123,6588,3075,800,17,-169.0
5395,14363,11317,2760,6074,5243,2215,143,-411.0
4905,14070,12587,3516,4078,8509,5914,1015,-94.0
5395,14383,11424,2813,5970,5454,2443,179,-377.0
4914,14170,12579,3470,4338,8241,5494,870,-147.0
5796,10512,6211,1202,5210,1001,92,0,293.0
6430,13405,8790,1848,6492,2298,421,4,-33.0
5704,14284,10683,2491,6420,4263,1444,60,-388.0
6282,13933,9548,2078,6628,2920,677,16,-181.0
6247,12420,7870,1611,6074,1796,272,1,86.0
5412,9466,5424,1022,4716,708,34,0,348.0
5803,14100,10371,2392,6390,3981,1320,49,-318.0
6161,13763,9526,2095,6482,3044,799,21,-171.0
6198,14101,9844,2173,6650,3194,801,12,-232.0
5655,14384,10984,2616,6272,4712,1840,105,-361.0
6256,14301,10048,2234,6692,3356,917,26,-231.0
6122,12173,7715,1580,5950,1765,273,4,84.0
6286,13646,9213,1982,6534,2679,578,10,-129.0
4890,14064,12751,3619,3788,8963,6488,1186,-42.0
6058,14066,9970,2229,6566,3404,934,26,-267.0
5444,14364,11305,2761,6044,5261,2276,152,-376.0
4074,6633,3580,641,3314,266,5,0,380.0
5045,14359,12230,3211,5194,7036,3971,441,-295.0
5813,14090,10330,2375,6410,3920,1270,47,-322.0
5854,14307,10522,2421,6518,4004,1271,40,-352.0
6000,14399,10491,2402,6570,3921,1259,50,-310.0
5421,14453,11438,2807,6034,5404,2385,189,-401.0
6353,12956,8351,1731,6316,2035,324,3,17.0
5548,14323,11000,2626,6244,4756,1835,106,-401.0
5034,14315,12213,3214,5142,7071,4031,456,-282.0
4929,14138,12493,3433,4388,8105,5362,839,-149.0
6365,13628,9082,1930,6584,2498,460,3,-111.0
5110,14331,12035,3123,5332,6703,3667,396,-309.0
4935,14182,12378,3347,4674,7704,4834,693,-216.0
6349,12541,7889,1603,6160,1729,221,1,94.0
5407,14437,11460,2816,6024,5436,2389,155,-386.0
6316,13527,9035,1926,6514,2521,499,6,-102.0
208,312,156,26,156,0,0,0,26.0
6277,12613,8062,1663,6146,1916,321,5,63.0
6287,12407,7801,1585,6092,1709,223,3,96.0
6261,13401,8958,1912,6444,2514,513,5,-94.0
4900,13879,12985,3945,2300,10685,9279,2478,61.0
5766,14287,10617,2465,6444,4173,1399,60,-369.0
5240,14474,11920,3031,5654,6266,3166,276,-345.0
4887,13964,12803,3718,3298,9505,7368,1573,8.0
5271,14374,11675,2933,5752,5923,2870,241,-361.0
5743,14350,10762,2521,6398,4364,1554,77,-366.0
5757,14406,10820,2537,6418,4402,1570,71,-366.0
6296,12024,7380,1471,5934,1446,156,0,181.0
5852,14182,10377,2378,6486,3891,1210,28,-331.0
608,924,468,79,462,6,0,0,73.0
5479,14365,11189,2703,6160,5029,2045,119,-400.0
5790,14107,10374,2389,6414,3960,1279,40,-332.0
5468,9798,5730,1099,4866,864,66,0,301.0
6405,13405,8812,1856,6488,2324,429,5,-44.0
5293,14412,11633,2901,5860,5773,2692,207,-387.0
6277,13943,9572,2087,6622,2950,699,17,-181.0
2124,3328,1735,301,1664,71,0,0,230.0
5839,14251,10478,2412,6484,3994,1283,47,-346.0
3182,5065,2679,471,2532,147,1,0,325.0
5836,10762,6432,1255,5334,1098,94,0,251.0
6021,14212,10221,2314,6558,3663,1096,31,-284.0
3572,5808,3131,560,2902,229,4,0,335.0
5867,14098,10274,2351,6442,3832,1214,41,-308.0
5895,14334,10513,2414,6542,3971,1250,33,-340.0
4990,14290,12254,3241,5062,7192,4166,502,-287.0
1084,1648,835,141,824,11,0,0,130.0
6173,14101,9873,2186,6630,3243,841,25,-241.0
4944,14152,12512,3446,4348,8164,5456,880,-142.0
6354,13309,8732,1833,6466,2266,377,0,-56.0
6296,13505,9053,1939,6472,2581,561,14,-95.0
5990,10841,6399,1238,5370,1029,101,0,310.0
4985,14162,12337,3341,4628,7709,4906,719,-181.0
4987,14276,12220,3223,5102,7118,4072,469,-292.0
5887,14118,10296,2360,6432,3864,1254,45,-295.0
6179,13071,8655,1833,6312,2343,447,7,-70.0
6323,13040,8512,1787,6302,2210,436,5,8.0
5952,11426,7045,1410,5630,1415,166,0,161.0
6278,13699,9286,2004,6548,2738,603,8,-139.0
5970,10695,6255,1200,5310,945,75,0,330.0
5763,14321,10684,2491,6422,4262,1477,71,-365.0
5903,14265,10416,2384,6528,3888,1209,35,-330.0
2240,3494,1815,314,1746,69,2,0,247.0
6338,13024,8454,1764,6324,2130,376,6,4.0
5861,14359,10586,2440,6532,4054,1295,33,-352.0
5510,14339,11148,2693,6138,5010,2063,120,-374.0
5277,14491,11780,2954,5836,5944,2819,217,-388.0
6209,13668,9323,2023,6508,2815,652,19,-159.0
6237,13846,9500,2070,6580,2920,686,15,-179.0
4909,13876,13019,4012,1966,11053,9944,2863,40.0
4927,14145,12477,3416,4458,8019,5229,783,-157.0
6268,12903,8417,1767,6232,2185,439,6,15.0
5016,14273,12373,3327,4784,7589,4705,654,-211.0
4422,7327,4014,728,3660,354,7,0,381.0
5334,14361,11563,2883,5828,5735,2705,200,-347.0
6216,13643,9287,2011,6508,2779,627,10,-151.0
5442,14406,11349,2773,6060,5289,2286,158,-388.0
6084,14087,9950,2217,6598,3352,891,26,-270.0
5631,14022,10534,2476,6212,4322,1598,85,-333.0
6350,13196,8624,1807,6406,2218,384,2,-29.0
5520,14286,11057,2663,6136,4921,2014,128,-372.0
6244,12742,8216,1704,6208,2008,326,8,14.0
5895,14048,10229,2345,6388,3841,1272,45,-269.0
5624,9954,5765,1097,4948,817,58,0,338.0
5479,14463,11473,2831,5960,5513,2543,203,-342.0
6192,13297,8945,1924,6346,2599,605,14,-84.0
6315,12498,7876,1603,6134,1742,230,1,90.0
5532,9886,5768,1104,4912,856,62,0,310.0
4911,13868,13018,4020,1916,11102,10036,2913,41.0
6017,14205,10170,2290,6600,3570,1005,33,-308.0
5503,14377,11182,2701,6158,5024,2061,131,-393.0
4899,14132,12600,3494,4236,8364,5660,917,-127.0
4913,13873,13047,4067,1692,11355,10489,3181,20.0
6066,13757,9582,2112,6492,3090,773,16,-221.0
4778,8033,4456,817,4010,446,13,0,384.0
5404,14369,11386,2797,5990,5396,2389,166,-376.0
5981,14163,10211,2317,6520,3691,1123,37,-288.0
6094,11392,6884,1356,5632,1252,128,2,230.0
5746,10179,5899,1123,5060,839,59,0,343.0
4176,6900,3774,684,3444,330,12,0,366.0
5004,14266,12201,3223,5064,7137,4138,508,-284.0
2196,3440,1793,311,1720,73,0,0,238.0
2408,3792,1986,346,1896,90,0,0,256.0
6091,13818,9643,2131,6500,3143,818,21,-215.0
4901,14010,12780,3685,3450,9330,7110,1479,-14.0
6324,13593,9103,1945,6536,2567,521,10,-111.0
6222,13902,9612,2112,6552,3060,798,30,-180.0
5851,14122,10283,2347,6484,3799,1154,37,-335.0
6288,12557,7974,1634,6144,1830,269,2,71.0
6173,12840,8406,1765,6222,2184,396,3,-26.0
6344,12811,8214,1698,6240,1974,331,6,49.0
6311,13404,8873,1875,6496,2377,412,5,-95.0
6270,12810,8282,1723,6226,2056,358,6,19.0
6343,12963,8380,1743,6302,2078,359,7,17.0
6185,13746,9437,2057,6532,2905,682,15,-181.0
4920,14226,12515,3396,4654,7861,4918,640,-187.0
5293,14339,11637,2926,5718,5919,2903,245,-335.0
6492,13413,8738,1828,6508,2230,397,6,-11.0
5250,14384,11823,3010,5586,6237,3212,306,-321.0
5813,14403,10771,2521,6416,4355,1571,77,-340.0
4906,14122,12590,3493,4222,8368,5678,922,-119.0
4912,13873,13050,4055,1770,11280,10333,3074,34.0
6338,12277,7622,1534,6040,1582,197,0,149.0
6085,13803,9622,2122,6512,3110,779,9,-218.0
4963,14244,12468,3380,4656,7812,4932,693,-193.0
4908,13874,13017,4007,1992,11025,9890,2828,44.0
4472,7400,4052,735,3694,358,12,0,389.0
4921,14131,12592,3504,4160,8432,5811,1005,-122.0
6333,13259,8716,1835,6422,2294,415,1,-45.0
5516,14386,11223,2724,6102,5121,2182,156,-371.0
5622,14373,11005,2624,6266,4739,1841,96,-370.0
5568,14297,10990,2631,6194,4796,1909,114,-370.0
4106,6777,3700,669,3386,314,5,0,360.0
6089,11373,6860,1348,5632,1228,109,1,228.0
5506,14386,11236,2727,6110,5126,2166,138,-371.0
5524,14436,11282,2742,6112,5170,2212,156,-372.0
5580,10092,5939,1144,5014,925,64,0,283.0
5781,14428,10788,2517,6474,4314,1480,59,-376.0
6390,13717,9186,1964,6588,2598,541,12,-105.0
920,1408,718,122,704,14,0,0,108.0
4898,14081,12687,3581,3888,8799,6305,1164,-77.0
4224,7026,3863,703,3508,355,10,0,358.0
4750,8071,4520,836,4024,496,23,0,363.0
6040,13585,9411,2066,6426,2985,733,14,-200.0
4878,13978,12704,3634,3604,9100,6770,1334,-30.0
4810,8097,4496,825,4042,454,13,0,384.0
5841,14352,10595,2444,6526,4069,1300,35,-360.0
5514,9947,5843,1124,4942,901,63,0,286.0
5236,14379,11825,3011,5584,6241,3211,310,-329.0
6367,12902,8308,1725,6266,2042,370,5,48.0
5118,14354,12048,3123,5358,6690,3638,382,-311.0
5481,14325,11165,2702,6118,5047,2089,125,-381.0
6311,13184,8654,1820,6388,2266,408,1,-39.0
5879,14167,10312,2355,6494,3818,1179,47,-331.0
5811,10696,6381,1243,5304,1077,88,1,253.0
6026,11867,7461,1517,5820,1641,227,0,103.0
5201,14381,12069,3145,5268,6801,3845,445,-256.0
5802,14412,10777,2520,6434,4343,1544,74,-353.0
4888,13883,12969,3923,2400,10569,9083,2386,51.0
6276,13545,9093,1946,6510,2583,525,10,-122.0
5609,14415,11076,2648,6264,4812,1887,101,-378.0
6226,12986,8512,1788,6296,2216,394,2,-36.0
6121,12034,7542,1528,5916,1626,202,3,101.0
6268,13759,9353,2021,6580,2773,599,6,-159.0
6127,11846,7343,1476,5830,1513,186,1,148.0
5972,13954,9919,2221,6512,3407,930,28,-284.0
5890,10915,6551,1283,5404,1147,107,0,243.0
5736,14237,10607,2469,6400,4207,1437,62,-363.0
6372,12853,8211,1689,6288,1923,277,2,41.0
4896,13934,12872,3794,2980,9892,7974,1836,40.0
6459,13283,8624,1799,6454,2170,375,3,1.0
3626,5905,3190,572,2948,242,9,0,339.0
2404,3788,1985,346,1894,91,0,0,255.0
2468,3888,2039,356,1942,97,4,0,263.0
4949,14178,12499,3422,4466,8033,5246,787,-152.0
5299,14409,11606,2889,5878,5728,2653,207,-393.0
5408,14398,11469,2835,5928,5541,2542,192,-356.0
6365,12882,8263,1707,6284,1979,314,3,39.0
6386,12756,8115,1667,6228,1887,300,2,78.0
6294,12532,7952,1630,6124,1828,284,2,84.0
6216,12545,8026,1654,6128,1898,289,2,43.0
5892,10620,6239,1201,5272,967,76,0,310.0
5232,14377,11735,2958,5722,6013,2933,246,-368.0
5436,14410,11428,2813,5978,5450,2454,176,-359.0
4894,13882,12989,3941,2332,10657,9218,2442,60.0
4386,7257,3972,720,3624,348,9,0,381.0
6220,13888,9559,2086,6602,2957,684,8,-195.0
5526,9815,5696,1085,4882,814,51,0,322.0
3386,5419,2881,509,2708,173,3,0,339.0
5407,14425,11612,2908,5776,5836,2873,259,-314.0
5875,14270,10444,2394,6524,3920,1222,41,-345.0
5660,14512,11158,2670,6296,4862,1920,92,-364.0
6217,13513,9157,1979,6440,2717,633,13,-118.0
6095,14178,10071,2257,6600,3471,978,33,-269.0
5523,14367,11197,2717,6092,5105,2183,159,-364.0
6310,13179,8643,1816,6390,2253,399,4,-42.0
3662,5893,3149,559,2944,205,5,0,359.0
5760,10542,6261,1215,5232,1029,78,0,264.0
4980,14175,12416,3384,4528,7888,5119,778,-163.0
6105,12322,7894,1630,6008,1886,306,3,47.0
4282,6963,3753,671,3480,273,3,0,401.0
6325,13603,9150,1966,6504,2646,595,9,-94.0
6027,14179,10160,2293,6562,3598,1055,35,-285.0
5886,10745,6377,1238,5326,1051,93,0,280.0
6179,11554,6990,1379,5706,1284,142,1,236.0
5036,14344,12166,3178,5264,6902,3816,412,-320.0
6322,13119,8576,1799,6358,2218,403,4,-20.0
5349,14448,11600,2881,5914,5686,2620,195,-380.0
5270,14472,11887,3019,5660,6227,3152,278,-334.0
5989,14327,10372,2356,6608,3764,1111,25,-322.0
5252,14384,11747,2963,5716,6031,2952,232,-348.0
6246,12488,7930,1624,6116,1814,256,2,64.0
6327,13472,8967,1907,6492,2475,488,5,-85.0
5136,14324,11956,3084,5408,6548,3508,360,-316.0
5476,14520,11489,2820,6058,5431,2404,168,-375.0
4891,13899,12969,3908,2490,10479,8919,2295,53.0
5812,10248,5907,1118,5106,801,36,0,353.0
5568,9814,5659,1072,4886,773,42,0,341.0
6073,13992,9859,2193,6560,3299,872,19,-253.0
6060,14000,9878,2198,6568,3310,864,12,-260.0
6036,11408,6947,1376,5638,1309,132,0,199.0
5385,14490,11611,2881,5936,5675,2618,199,-375.0
6314,13880,9429,2035,6648,2781,584,10,-172.0
6276,13300,8820,1870,6420,2400,460,4,-74.0
5584,9906,5747,1095,4924,823,58,0,330.0
6207,14021,9717,2131,6648,3069,725,15,-228.0
5107,14315,12092,3158,5236,6856,3843,419,-274.0
5629,14466,11126,2663,6274,4852,1918,103,-374.0
6094,13515,9255,2012,6438,2817,639,12,-178.0
5064,8764,4978,931,4370,608,24,0,347.0
4898,13903,12956,3904,2488,10468,8927,2316,47.0
6355,13444,8893,1880,6506,2387,432,1,-76.0
6282,13320,8842,1877,6422,2420,476,6,-73.0
5326,14317,11446,2833,5894,5552,2529,188,-378.0
5299,14401,11740,2967,5678,6062,3045,279,-329.0
1264,1928,980,166,964,16,0,0,150.0
4630,7689,4221,767,3840,381,9,0,395.0
5120,14336,12065,3142,5278,6787,3780,428,-293.0
6328,12847,8253,1706,6270,1983,307,2,28.0
5940,14215,10339,2366,6482,3857,1251,62,-302.0
4913,13875,13031,4041,1816,11215,10243,3041,28.0
6019,14040,9994,2242,6536,3458,968,21,-269.0
6292,12635,8052,1654,6180,1872,275,2,55.0
4140,6908,3809,695,3448,361,12,0,346.0
4911,13904,12945,3896,2514,10431,8876,2285,56.0
4892,13931,12917,3839,2800,10117,8331,2014,39.0
4634,7713,4244,773,3850,394,13,0,392.0
5921,14116,10229,2331,6472,3757,1172,43,-297.0
6232,12112,7534,1518,5960,1574,192,0,136.0
5459,14376,11259,2736,6102,5157,2172,145,-394.0
5579,14336,10971,2610,6282,4689,1772,89,-396.0
5436,14410,11354,2772,6076,5278,2258,144,-392.0
6031,11176,6714,1317,5526,1188,124,1,252.0
5620,14400,10986,2606,6336,4650,1728,84,-400.0
5253,14416,11727,2944,5790,5937,2836,223,-380.0
3136,4996,2644,465,2498,146,0,0,319.0
6274,13578,9140,1961,6514,2626,550,10,-125.0
5579,14518,11216,2687,6310,4906,1898,89,-410.0
6217,12369,7824,1597,6066,1758,237,1,75.0
6150,13361,9023,1941,6400,2623,561,8,-129.0
6215,13952,9653,2117,6604,3049,744,13,-201.0
6300,12795,8232,1705,6234,1998,327,2,32.0
5440,9574,5517,1045,4764,753,46,0,338.0
6197,12522,8019,1654,6114,1905,294,3,40.0
5827,14005,10220,2343,6382,3838,1241,47,-301.0
5775,14416,10756,2502,6500,4256,1416,49,-387.0
4910,13866,13034,4056,1732,11302,10402,3134,22.0
5951,14217,10294,2341,6542,3752,1133,35,-313.0
5050,8693,4922,919,4330,592,33,0,360.0
6000,13949,9919,2226,6482,3437,985,30,-256.0
6243,13826,9489,2070,6558,2931,710,13,-164.0
6414,13806,9268,1985,6626,2642,554,6,-109.0
5894,10845,6471,1261,5376,1095,93,0,259.0
4987,14243,12230,3236,5044,7186,4155,467,-262.0
6056,13757,9579,2110,6498,3081,761,22,-232.0
6325,12497,7879,1606,6122,1757,253,1,101.0
5729,14480,10953,2581,6420,4533,1640,67,-379.0
5867,14156,10374,2388,6420,3954,1316,53,-303.0
2206,3461,1807,314,1730,77,1,0,238.0
6270,13707,9273,1995,6576,2697,555,12,-159.0
6298,12739,8157,1681,6228,1929,283,0,35.0
4901,13972,12817,3719,3320,9497,7332,1527,27.0
5882,14188,10331,2359,6508,3823,1172,42,-334.0
5985,10993,6558,1279,5442,1116,109,1,271.0
6281,12678,8110,1671,6194,1916,290,3,42.0
6149,14047,9852,2186,6588,3264,871,25,-232.0
6245,12188,7606,1537,5990,1616,208,3,126.0
4865,14014,12738,3631,3690,9048,6634,1259,-42.0
5438,14453,11386,2779,6098,5288,2257,156,-408.0
5694,14442,10906,2563,6434,4472,1574,70,-405.0
4981,14161,12429,3394,4494,7935,5173,777,-145.0
6268,13200,8705,1837,6388,2317,424,8,-64.0
5619,14398,11065,2649,6236,4829,1926,109,-363.0
6302,12707,8131,1677,6200,1931,307,4,49.0
5550,14437,11197,2697,6212,4985,2013,112,-387.0
4996,14269,12482,3391,4618,7864,5033,742,-182.0
596,908,461,78,454,7,0,0,71.0
5986,14391,10496,2405,6562,3934,1267,52,-314.0
5096,14331,12065,3134,5326,6739,3679,378,-304.0
6047,14125,10074,2265,6558,3516,1009,27,-269.0
5169,14374,11914,3047,5546,6368,3282,299,-338.0
5433,14460,11493,2835,5976,5517,2508,195,-369.0
5806,10287,5960,1134,5116,844,55,0,345.0
5295,14394,11613,2895,5856,5757,2682,201,-381.0
6258,13287,8818,1870,6416,2402,455,4,-81.0
5595,14476,11185,2687,6248,4937,1980,113,-383.0
6113,13406,9150,1990,6360,2790,686,19,-133.0
6223,12284,7742,1578,6016,1726,252,1,103.0
4900,13895,12923,3866,2650,10273,8595,2126,62.0
6068,13906,9788,2179,6502,3286,902,24,-229.0
6367,12610,7965,1626,6174,1791,262,1,96.0
5835,14132,10346,2376,6436,3910,1260,53,-327.0
5142,14391,12043,3112,5414,6629,3563,364,-318.0
6327,12647,8043,1651,6180,1863,287,3,72.0
6139,12044,7535,1524,5926,1609,192,1,106.0
5368,9332,5322,999,4650,672,32,0,359.0
5792,14265,10620,2474,6396,4224,1473,50,-327.0
6454,13608,8993,1902,6574,2419,460,6,-63.0
5948,10706,6284,1209,5314,970,78,0,317.0
4873,14014,12668,3587,3814,8854,6386,1179,-60.0
5489,14460,11293,2734,6182,5111,2096,131,-412.0
6284,12486,7921,1625,6092,1829,302,4,94.0
6227,13857,9527,2080,6574,2953,709,19,-183.0
6331,13041,8467,1765,6344,2123,353,3,-8.0
6274,12517,7941,1626,6126,1815,265,4,72.0
4919,14169,12520,3430,4460,8060,5249,779,-160.0
5071,14339,12110,3154,5296,6814,3747,399,-312.0
1256,1932,990,169,966,24,0,0,145.0
5281,14309,11517,2865,5844,5673,2621,189,-376.0
5947,10936,6525,1272,5418,1107,100,1,264.0
6069,11179,6676,1302,5540,1136,99,1,264.0
5144,14350,11913,3052,5514,6399,3322,320,-345.0
5988,11467,7062,1413,5646,1416,175,2,170.0
3398,5469,2921,518,2734,187,1,0,332.0
4160,6900,3786,688,3444,342,12,0,358.0
4962,14227,12444,3366,4692,7752,4843,644,-187.0
4098,6687,3617,649,3340,277,7,0,379.0
5312,14447,11711,2934,5818,5893,2811,210,-358.0
5776,10580,6292,1223,5246,1046,88,0,265.0
5972,11040,6607,1290,5474,1133,92,0,249.0
6361,12862,8254,1707,6266,1988,330,3,46.0
724,1096,553,93,548,5,0,0,88.0
6022,13797,9665,2138,6502,3163,793,16,-248.0
5850,10633,6282,1214,5280,1002,73,0,285.0
6219,13604,9241,1998,6494,2747,616,9,-142.0
4930,14120,12583,3499,4172,8411,5776,970,-106.0
4874,13940,12891,3788,3054,9837,7832,1746,37.0
3992,6562,3573,645,3276,297,10,0,358.0
5523,9832,5721,1093,4884,837,64,1,319.0
5774,14402,10772,2516,6448,4324,1506,70,-372.0
4907,14165,12411,3364,4638,7773,4889,691,-211.0
5510,9749,5647,1075,4844,803,61,0,333.0
5669,14361,10905,2584,6306,4599,1749,105,-371.0
6105,14114,9974,2224,6604,3370,906,19,-259.0
3126,5001,2657,469,2500,157,1,0,313.0
5727,14262,10661,2488,6394,4267,1474,57,-362.0
6221,13020,8555,1801,6304,2251,412,7,-45.0
6247,11918,7319,1461,5872,1447,174,1,187.0
6267,13935,9610,2107,6578,3032,779,19,-165.0
6172,13863,9594,2106,6552,3042,759,26,-203.0
5440,14388,11343,2774,6042,5301,2304,156,-379.0
5290,14469,11739,2941,5832,5907,2805,220,-381.0
4882,14018,12739,3632,3686,9053,6646,1254,-29.0
6344,13293,8728,1834,6452,2276,389,2,-55.0
6110,13977,9785,2164,6586,3199,805,16,-246.0
5795,13846,10013,2273,6388,3625,1070,29,-311.0
5973,14129,10120,2279,6566,3554,997,37,-315.0
5430,14505,11492,2817,6082,5410,2341,148,-400.0
5196,14389,11925,3060,5490,6435,3409,362,-328.0
5973,14068,10076,2271,6526,3550,1016,27,-290.0
5947,14133,10191,2311,6516,3675,1101,43,-306.0
5193,14397,11888,3031,5590,6298,3217,297,-347.0
6228,13135,8654,1822,6376,2278,383,2,-75.0
5854,14277,10519,2429,6464,4055,1349,56,-333.0
6213,11955,7382,1479,5890,1492,175,1,161.0
4999,14244,12307,3289,4880,7427,4484,573,-227.0
5322,9561,5602,1076,4748,854,65,0,287.0
5774,14324,10664,2480,6448,4216,1428,58,-366.0
128,192,96,16,96,0,0,0,16.0
5897,14222,10413,2395,6456,3957,1310,55,-307.0
5580,10006,5848,1120,4976,872,54,0,302.0
5644,14513,11208,2698,6228,4980,2057,134,-359.0
6098,11690,7211,1446,5746,1465,198,6,173.0
5182,8963,5094,954,4464,630,35,0,359.0
6058,11537,7080,1413,5682,1398,173,0,188.0
4686,7845,4335,792,3918,417,9,0,384.0
5296,14393,11544,2857,5946,5598,2501,170,-410.0
6095,13749,9532,2092,6512,3020,725,11,-214.0
5424,9604,5558,1056,4780,778,44,0,322.0
6168,13742,9467,2071,6508,2959,726,16,-178.0
6088,13683,9467,2075,6484,2983,715,10,-203.0
4903,13885,13020,3980,2160,10860,9565,2627,58.0
5042,8619,4849,900,4298,551,23,0,372.0
5031,14256,12159,3205,5088,7071,4080,485,-271.0
4888,14085,12651,3546,4026,8625,6033,1046,-92.0
5544,9726,5587,1055,4844,743,38,0,350.0
5771,14409,10841,2550,6382,4459,1645,83,-347.0
5257,14361,11664,2931,5742,5922,2877,257,-371.0
4914,13908,12935,3885,2560,10375,8788,2242,56.0
4897,14059,12699,3598,3810,8889,6439,1209,-61.0
6311,13279,8778,1859,6402,2376,475,7,-49.0
6323,12843,8264,1712,6256,2008,331,3,32.0
5031,14272,12168,3206,5100,7068,4072,489,-279.0
6302,12604,8016,1645,6162,1854,280,2,69.0
2412,3812,2003,350,1906,97,0,0,253.0
952,1444,730,123,722,8,0,0,115.0
4284,7228,4029,743,3600,429,28,0,342.0
6264,12473,7918,1624,6092,1826,289,2,85.0
5152,14379,11969,3079,5464,6505,3451,362,-337.0
4887,13941,12913,3819,2912,10001,8117,1895,40.0
4932,14156,12594,3489,4254,8340,5648,916,-119.0
6111,14093,9912,2199,6630,3282,833,19,-269.0
5866,14051,10200,2326,6444,3756,1163,44,-311.0
6306,13215,8680,1825,6410,2270,395,4,-54.0
3984,6466,3481,622,3230,251,6,0,377.0
5762,10409,6120,1178,5172,948,65,0,295.0
4934,14087,12647,3561,3928,8719,6231,1140,-67.0
6229,13455,9054,1943,6450,2604,555,9,-115.0
6015,14163,10117,2273,6596,3521,971,27,-304.0
5818,10703,6395,1249,5296,1099,111,0,261.0
3944,6392,3436,613,3194,242,4,0,375.0
6144,14140,9993,2233,6588,3405,964,28,-236.0
5830,10581,6251,1209,5248,1003,85,0,291.0
6072,13986,9862,2196,6548,3314,890,20,-248.0
5960,14379,10529,2420,6538,3991,1303,42,-310.0
6247,12290,7723,1570,6026,1697,238,1,110.0
6153,12334,7860,1616,6024,1836,286,3,63.0
5525,14404,11191,2703,6164,5027,2076,143,-391.0
4875,13954,12820,3738,3212,9608,7530,1657,3.0
6047,14157,10084,2262,6596,3488,965,27,-288.0
6229,14103,9843,2177,6624,3219,855,21,-208.0
5949,14025,10027,2255,6524,3503,977,33,-304.0
5792,10316,6006,1148,5124,882,68,0,334.0
5107,14342,11983,3091,5420,6563,3502,373,-343.0
4894,13896,12938,3892,2524,10414,8848,2282,44.0
6422,12790,8107,1659,6260,1847,270,2,80.0
5858,14341,10645,2480,6410,4235,1521,84,-318.0
5520,9728,5608,1062,4844,764,40,0,338.0
5842,14227,10478,2419,6442,4036,1343,52,-326.0
4922,14177,12375,3337,4728,7647,4721,628,-217.0
6391,12620,7957,1623,6176,1781,268,5,105.0
6443,13607,8998,1903,6578,2420,451,3,-69.0
6173,11989,7461,1505,5892,1569,205,1,140.0
4908,14069,12519,3469,4224,8295,5621,906,-111.0
5612,14487,11190,2689,6246,4944,1995,114,-374.0
6207,13208,8767,1858,6386,2381,436,5,-92.0
6020,14330,10344,2347,6606,3738,1118,40,-313.0
4880,13956,12861,3760,3162,9699,7632,1668,25.0
5496,14387,11220,2716,6144,5076,2099,126,-387.0
5531,14434,11240,2718,6172,5068,2090,121,-381.0
6363,12772,8150,1678,6232,1918,308,5,63.0
4170,6823,3697,664,3410,287,3,0,380.0
4911,13872,13016,4010,1972,11044,9928,2849,45.0
4882,14016,12725,3631,3664,9061,6688,1298,-40.0
5926,14062,10131,2295,6492,3639,1078,34,-300.0
3954,6515,3553,642,3254,299,7,0,350.0
6424,13261,8608,1792,6464,2144,333,2,-21.0
6264,13823,9444,2051,6582,2862,659,14,-166.0
6209,13834,9531,2085,6552,2979,730,15,-179.0
5444,9490,5424,1020,4728,696,34,0,358.0
4892,13889,12931,3896,2486,10445,8917,2330,38.0
6246,12033,7427,1486,5938,1489,157,0,154.0
5742,14461,10946,2588,6364,4582,1733,100,-361.0
5304,9184,5234,984,4564,670,56,0,370.0
6288,13461,9033,1939,6432,2601,597,14,-79.0
4848,8138,4509,826,4062,447,14,0,393.0
5134,14373,12103,3149,5312,6791,3749,392,-285.0
6005,13921,9875,2212,6478,3397,965,33,-253.0
5001,14318,12328,3281,4970,7358,4378,571,-270.0
6354,13435,8931,1903,6444,2487,547,16,-53.0
3368,5386,2863,506,2690,173,6,0,339.0
6346,12577,7942,1620,6164,1778,249,0,91.0
5251,14424,11698,2925,5846,5852,2732,205,-400.0
5798,14277,10536,2431,6486,4050,1305,60,-374.0
6009,11598,7186,1445,5702,1484,194,3,152.0
4886,14052,12659,3566,3922,8737,6208,1110,-73.0
6168,13844,9592,2108,6536,3056,772,16,-192.0
5874,14190,10389,2387,6456,3933,1278,46,-314.0
4890,8381,4728,880,4176,552,29,0,357.0
312,472,238,40,236,2,0,0,38.0
4895,13884,12933,3891,2520,10413,8844,2269,53.0
5562,14340,10983,2613,6288,4695,1764,90,-408.0
6046,14170,10125,2280,6570,3555,1030,34,-279.0
4945,14173,12567,3467,4332,8235,5509,869,-128.0
6187,13727,9431,2059,6508,2923,711,15,-168.0
6303,12863,8293,1719,6272,2021,319,3,14.0
4953,14188,12454,3391,4562,7892,5064,735,-172.0
6296,13613,9177,1974,6510,2667,593,14,-114.0
4746,8021,4470,823,4002,468,17,0,372.0
6256,13169,8667,1824,6390,2277,389,6,-70.0
4654,7731,4246,772,3860,386,11,0,397.0
5680,10078,5847,1114,5010,837,58,0,335.0
6076,11392,6905,1364,5626,1279,140,0,225.0
4948,14209,12290,3278,4912,7378,4385,534,-249.0
6381,13476,8945,1902,6478,2467,520,7,-52.0
4802,7971,4377,796,3978,399,15,0,412.0
6138,14025,9825,2176,6594,3231,837,20,-238.0
6072,11406,6907,1361,5648,1259,110,0,212.0
6046,13943,9824,2184,6544,3280,855,16,-257.0
6299,13272,8768,1854,6412,2356,448,5,-59.0
6095,13197,8877,1902,6342,2535,513,7,-127.0
6164,13923,9662,2122,6592,3070,739,10,-219.0
6070,11423,6946,1376,5636,1310,151,0,217.0
5504,14423,11261,2730,6142,5119,2139,138,-388.0
6306,13109,8579,1801,6352,2227,405,4,-25.0
5056,14303,12096,3160,5232,6864,3839,446,-311.0
6369,13154,8581,1799,6368,2213,418,7,-3.0
6134,13850,9652,2133,6506,3146,838,22,-197.0
4978,14200,12306,3301,4806,7500,4588,606,-217.0
6265,13843,9477,2063,6576,2901,691,17,-164.0
6337,13074,8515,1782,6338,2177,398,7,-4.0
6210,11795,7203,1429,5832,1371,131,0,189.0
6284,13162,8657,1824,6370,2287,422,4,-45.0
6243,12192,7617,1541,5988,1629,216,1,127.0
5630,14155,10646,2496,6316,4330,1523,64,-375.0
5793,14410,10768,2512,6464,4304,1482,51,-361.0
6141,13923,9717,2148,6546,3171,831,21,-213.0
6067,14207,10134,2278,6600,3534,1007,35,-284.0
5751,14261,10609,2464,6434,4175,1393,47,-365.0
788,1204,613,104,602,11,0,0,93.0
6342,13006,8444,1764,6304,2140,398,6,16.0
6177,11821,7268,1451,5830,1438,161,1,173.0
6248,12414,7860,1608,6072,1788,270,4,86.0
3050,4839,2553,448,2418,135,3,0,316.0
6002,14091,10058,2260,6556,3502,979,28,-291.0
6176,12840,8405,1765,6220,2185,400,4,-24.0
5904,11096,6724,1326,5492,1232,112,0,206.0
6258,12099,7495,1505,5960,1535,179,0,149.0
6128,11814,7307,1466,5818,1489,178,0,155.0
6306,12984,8436,1761,6306,2130,372,6,-3.0
6183,13842,9538,2083,6578,2960,686,13,-204.0
5766,14375,10747,2507,6452,4295,1471,52,-369.0
5988,14145,10168,2300,6536,3632,1073,30,-289.0
88,132,66,11,66,0,0,0,11.0
5337,14406,11531,2853,5944,5587,2518,175,-391.0
5609,14438,11098,2654,6272,4826,1894,107,-385.0
6240,13741,9341,2016,6586,2755,569,6,-176.0
5152,14414,12015,3091,5484,6531,3446,344,-338.0
5468,14310,11168,2706,6100,5068,2110,128,-380.0
4090,6629,3562,635,3314,248,1,0,388.0
5444,9794,5740,1102,4868,872,58,0,288.0
4876,13936,12816,3737,3210,9606,7516,1628,19.0
5566,9791,5636,1066,4876,760,39,0,345.0
3512,5652,3020,536,2824,196,4,0,344.0
4198,6901,3757,678,3446,311,9,0,376.0
672,1012,508,85,506,2,0,0,83.0
6218,13426,9031,1937,6440,2591,546,6,-114.0
4999,14301,12277,3254,5030,7247,4241,527,-279.0
5443,14437,11427,2802,6042,5385,2353,139,-369.0
5520,14430,11240,2719,6166,5074,2098,132,-389.0
6036,14187,10137,2279,6600,3537,987,22,-293.0
5860,14317,10570,2445,6470,4100,1377,54,-332.0
5202,8947,5065,946,4454,611,39,0,374.0
4891,13918,12926,3870,2632,10294,8654,2201,29.0
4908,13870,12997,3982,2102,10895,9666,2700,53.0
5894,14080,10186,2314,6488,3698,1104,34,-314.0
5147,14313,11950,3086,5384,6566,3545,367,-302.0
6280,12743,8181,1690,6222,1959,299,2,28.0
5350,14432,11627,2902,5842,5785,2748,222,-357.0
4937,14177,12431,3378,4594,7837,4989,717,-187.0
6307,13289,8782,1858,6416,2366,457,7,-58.0
2296,3636,1914,335,1818,96,0,0,239.0
6341,13468,8970,1912,6468,2502,532,11,-69.0
5995,14304,10341,2349,6588,3753,1128,41,-317.0
5494,9887,5802,1116,4908,894,71,0,293.0
6344,12472,7838,1594,6112,1726,248,0,116.0
5936,10906,6503,1267,5404,1099,98,0,266.0
1836,2808,1431,243,1404,27,0,0,216.0
2846,4481,2347,409,2240,107,1,0,303.0
5956,10986,6570,1283,5442,1128,102,0,257.0
5128,8950,5123,965,4456,667,38,0,336.0
6187,14212,9975,2210,6690,3285,832,17,-260.0
5940,10948,6535,1273,5432,1103,84,0,254.0
5824,10700,6386,1246,5296,1090,108,0,264.0
6290,13590,9123,1952,6534,2589,522,14,-129.0
6461,13605,9003,1909,6552,2451,501,9,-50.0
6214,11991,7418,1488,5908,1510,175,0,153.0
5485,14373,11207,2712,6142,5065,2089,129,-393.0
1148,1748,887,150,874,13,0,0,137.0
4978,14230,12357,3322,4782,7575,4666,630,-217.0
5008,14210,12181,3231,4976,7205,4258,536,-252.0
6159,13482,9160,1980,6440,2720,602,5,-143.0
6192,12621,8126,1682,6160,1966,301,2,15.0
6089,12302,7864,1618,6020,1844,262,3,33.0
6050,14051,9980,2237,6538,3442,975,28,-258.0
6132,11428,6895,1357,5648,1247,132,0,242.0
5740,14309,10702,2499,6410,4292,1489,62,-366.0
5486,9633,5543,1049,4792,751,49,0,347.0
5859,10948,6619,1305,5408,1211,132,1,225.0
6186,11619,7039,1388,5750,1289,119,0,218.0
5876,14279,10473,2406,6510,3963,1259,38,-336.0
5750,14351,10743,2509,6432,4311,1487,52,-367.0
5476,14304,11153,2702,6094,5059,2116,136,-377.0
5697,14338,10805,2540,6370,4435,1598,79,-376.0
5042,14243,12172,3221,5018,7154,4207,524,-250.0
5938,14325,10453,2393,6548,3905,1229,44,-327.0
6275,12964,8434,1761,6302,2132,360,5,-16.0
5702,10267,6028,1160,5096,932,75,0,303.0
6129,14079,9901,2199,6608,3293,863,17,-248.0
5876,10848,6489,1267,5376,1113,96,0,250.0
6130,12268,7827,1613,5976,1851,316,2,76.0
6391,13651,9100,1937,6578,2522,495,7,-97.0
4900,13927,12925,3845,2780,10145,8367,2014,53.0
6291,13013,8485,1776,6314,2171,385,3,-13.0
5155,14337,11853,3021,5580,6273,3177,275,-350.0
6204,12016,7459,1501,5912,1547,192,0,146.0
5906,14418,10634,2456,6532,4102,1354,42,-334.0
4904,13881,12989,3960,2218,10771,9445,2582,52.0
4905,14000,12784,3691,3422,9362,7156,1487,-2.0
6155,11460,6909,1359,5664,1245,132,1,245.0
5749,14471,10921,2572,6410,4511,1651,85,-373.0
6295,13735,9318,2014,6552,2766,631,15,-136.0
5780,14260,10587,2457,6432,4155,1396,48,-350.0
5292,14330,11532,2867,5862,5670,2606,176,-373.0
876,1328,671,113,664,7,0,0,106.0
6018,11053,6584,1281,5482,1102,89,0,268.0
6225,12729,8231,1712,6190,2041,349,5,15.0
5981,14095,10081,2267,6560,3521,975,21,-300.0
5645,14438,11004,2609,6354,4650,1730,87,-398.0
5592,14407,11043,2628,6318,4725,1771,74,-400.0
5987,14178,10184,2299,6574,3610,1030,25,-306.0
4688,7924,4416,813,3954,462,16,0,367.0
6174,13924,9653,2120,6586,3067,752,22,-217.0
872,1324,670,113,662,8,0,0,105.0
6114,13903,9712,2147,6542,3170,819,20,-224.0
4900,13881,12971,3938,2314,10657,9253,2482,52.0
3998,6517,3521,631,3256,265,5,0,371.0
5971,13995,10031,2267,6460,3571,1075,31,-260.0
6196,13986,9723,2142,6594,3129,798,20,-209.0
360,544,274,46,272,2,0,0,44.0
5782,10481,6191,1198,5194,997,93,0,294.0
5872,10680,6320,1224,5296,1024,88,0,288.0
6073,13351,9083,1964,6382,2701,587,9,-159.0
6135,13400,9063,1949,6432,2631,536,5,-151.0
6205,12447,7930,1629,6086,1844,275,1,59.0
5997,14231,10225,2308,6602,3623,1027,29,-317.0
5155,14391,11910,3038,5592,6318,3207,291,-364.0
6045,14106,10076,2270,6532,3544,1042,23,-255.0
6199,13572,9230,1998,6472,2758,628,9,-141.0
6231,13290,8863,1889,6392,2471,506,9,-85.0
4925,14064,12688,3594,3812,8876,6440,1203,-45.0
6132,14126,9934,2205,6638,3296,850,24,-265.0
4906,13874,12999,3967,2196,10803,9482,2582,64.0
4895,13904,12910,3856,2684,10226,8536,2121,45.0
792,1204,610,103,602,8,0,0,95.0
6299,13114,8581,1800,6362,2219,390,5,-34.0
5904,14241,10416,2395,6462,3954,1317,74,-316.0
6241,12931,8422,1759,6290,2132,351,5,-27.0
5967,13958,9955,2238,6482,3473,994,33,-274.0
5182,9013,5141,965,4492,649,29,0,345.0
3760,6082,3263,581,3040,223,2,0,360.0
6025,14211,10186,2297,6590,3596,1031,29,-297.0
6191,13486,9116,1961,6466,2650,554,5,-140.0
4378,7225,3946,714,3608,338,9,0,385.0
5865,14126,10277,2345,6484,3793,1158,39,-329.0
6065,14028,9926,2218,6544,3382,940,31,-255.0
6223,13654,9286,2008,6524,2762,606,5,-153.0
6201,12957,8494,1783,6290,2204,377,1,-45.0
6005,13989,9953,2234,6502,3451,985,33,-265.0
4911,13868,13014,4017,1926,11088,10016,2905,40.0
6225,11955,7373,1476,5890,1483,175,1,167.0
5974,13987,9973,2240,6506,3467,975,28,-280.0
6066,13853,9690,2144,6516,3174,821,32,-241.0
6041,13846,9766,2180,6452,3314,942,27,-219.0
4896,13900,12951,3894,2538,10413,8824,2252,53.0
6326,13515,9027,1926,6498,2529,519,4,-88.0
5966,11081,6667,1309,5480,1187,121,0,243.0
5866,14183,10360,2373,6482,3878,1219,44,-330.0
5262,14447,11790,2975,5730,6060,2987,272,-370.0
6118,14021,9862,2194,6560,3302,901,28,-235.0
6218,12501,7978,1641,6110,1868,281,0,54.0
5283,14490,11770,2949,5846,5924,2798,209,-386.0
6306,12119,7467,1492,5982,1485,155,0,162.0
5090,8805,5004,937,4386,618,33,0,352.0
6429,13966,9430,2028,6692,2738,582,7,-135.0
5474,14391,11230,2715,6170,5060,2051,108,-402.0
5034,8619,4851,900,4302,549,15,0,366.0
6305,13599,9143,1961,6520,2623,559,9,-112.0
6202,13861,9528,2075,6606,2922,649,8,-206.0
4134,6801,3705,669,3396,309,9,0,369.0
3810,6207,3351,600,3102,249,3,0,354.0
6038,11225,6749,1323,5560,1189,105,0,239.0
6075,14111,10064,2268,6520,3544,1071,35,-240.0
4899,13959,12854,3769,3094,9760,7771,1755,25.0
4891,13902,12899,3840,2758,10141,8386,2037,48.0
4030,6621,3603,650,3306,297,9,0,362.0
2714,4281,2246,392,2140,106,1,0,287.0
64,96,48,8,48,0,0,0,8.0
6304,13946,9532,2069,6650,2882,646,12,-179.0
6268,13473,9024,1928,6480,2544,513,6,-109.0
4879,14013,12769,3668,3530,9239,6953,1415,-33.0
5767,14374,10762,2519,6410,4352,1554,85,-364.0
6219,12026,7460,1501,5914,1546,198,1,152.0
5078,14309,12132,3177,5202,6930,3905,428,-276.0
3016,4760,2498,436,2380,118,0,0,318.0
5812,14280,10606,2469,6398,4208,1484,76,-331.0
5526,9847,5732,1095,4894,838,59,0,316.0
6136,11823,7315,1469,5816,1499,191,2,159.0
6142,13570,9278,2016,6460,2818,650,14,-166.0
5470,14488,11479,2826,6002,5477,2484,198,-365.0
4873,14017,12702,3610,3744,8958,6529,1233,-52.0
5686,14320,10775,2527,6388,4387,1544,70,-386.0
4830,8155,4540,835,4070,470,15,0,380.0
6029,14106,10053,2257,6564,3489,978,27,-281.0
4913,13872,13051,4087,1580,11471,10712,3323,5.0
5289,14332,11528,2869,5842,5686,2648,215,-384.0
5696,14291,10726,2509,6398,4328,1495,54,-378.0
6261,13962,9639,2114,6594,3045,774,19,-176.0
2726,4273,2229,387,2136,93,1,0,295.0
6240,13363,8941,1911,6416,2525,531,10,-93.0
5965,11320,6932,1382,5572,1360,176,3,195.0
5192,14368,11729,2949,5764,5965,2840,220,-396.0
5911,14223,10382,2380,6484,3898,1255,47,-310.0
4921,14120,12567,3483,4236,8331,5648,915,-115.0
5790,10511,6214,1203,5210,1004,91,0,290.0
5013,14249,12317,3295,4864,7453,4521,577,-214.0
5695,14367,10821,2539,6408,4413,1551,67,-390.0
6257,13554,9125,1957,6508,2617,538,7,-129.0
2312,3612,1878,325,1806,72,0,0,253.0
5048,14252,12032,3130,5284,6748,3684,368,-302.0
5893,14350,10514,2411,6562,3952,1226,39,-354.0
5304,9260,5306,1001,4606,700,48,0,349.0
6163,13281,8926,1914,6368,2558,545,7,-106.0
6069,13814,9609,2111,6552,3057,710,11,-247.0
5824,10680,6354,1235,5298,1056,84,0,263.0
6174,12087,7572,1536,5928,1644,231,0,123.0
6252,13099,8635,1825,6320,2315,459,6,-37.0
6260,12444,7888,1616,6080,1808,284,4,88.0
4978,8587,4869,910,4278,591,31,0,350.0
6488,13276,8600,1793,6442,2158,392,8,19.0
2598,4073,2125,369,2036,89,1,0,281.0
5329,14354,11578,2893,5798,5780,2758,211,-340.0
5666,14387,10962,2604,6300,4662,1787,92,-363.0
6300,13273,8781,1861,6396,2385,481,10,-53.0
5964,14205,10323,2360,6486,3837,1233,34,-278.0
6161,12533,8066,1670,6112,1954,309,1,24.0
6227,11708,7109,1406,5782,1327,144,1,222.0
5479,14480,11357,2761,6148,5209,2184,141,-405.0
4997,14252,12353,3316,4810,7543,4632,623,-218.0
5954,14451,10627,2452,6542,4085,1367,56,-322.0
5764,14497,10877,2542,6502,4375,1493,58,-398.0
6339,12581,7965,1630,6150,1815,281,3,93.0
5812,10930,6638,1313,5398,1240,134,0,207.0
6253,12893,8406,1762,6240,2166,413,5,4.0
6117,14068,9916,2208,6584,3332,900,19,-243.0
6420,13277,8623,1795,6476,2147,325,2,-29.0
5453,14463,11401,2787,6080,5321,2303,165,-396.0
6321,12411,7789,1582,6086,1703,239,1,117.0
6017,14053,10037,2260,6514,3523,1025,21,-259.0
6287,13147,8647,1823,6356,2291,435,3,-36.0
5750,14491,10901,2555,6472,4429,1547,68,-395.0
3750,6045,3235,575,3020,215,5,0,365.0
2572,4020,2091,362,2010,81,0,0,281.0
5518,14358,11138,2684,6172,4966,2014,118,-386.0
5953,14198,10267,2333,6536,3731,1126,39,-311.0
6369,13307,8764,1852,6416,2348,475,5,-26.0
5807,14083,10294,2357,6446,3848,1191,39,-339.0
6098,13601,9393,2061,6420,2973,761,20,-171.0
4855,13973,12788,3694,3412,9376,7149,1491,-24.0
6348,13675,9178,1965,6566,2612,543,10,-114.0
6045,13757,9614,2125,6478,3136,801,13,-223.0
5915,14386,10577,2438,6526,4051,1334,53,-332.0
6265,12974,8458,1769,6302,2156,370,3,-20.0
