N0,N1,N2,Volume,Enclosing_surface,Contact_surface,TETRAVOXEL,OCTOVOXEL,MISC_Async
44740,110198,81216,18687,50310,30906,9578,288,-2929.0
47989,105187,71368,15394,50372,20996,4443,65,-1224.0
37773,109789,94338,24865,39486,54852,30817,3373,-2543.0
45742,109960,79785,18153,50652,29133,8656,262,-2586.0
48413,102592,67929,14373,49620,18309,3352,39,-623.0
45615,109539,79274,17988,50620,28654,8299,271,-2638.0
35603,105480,100173,29964,20562,79611,64356,14377,332.0
48647,99063,63721,13179,48368,15353,2327,27,126.0
45232,81941,48298,9318,40688,7610,565,2,2271.0
36272,108074,96799,26643,33740,63059,40594,5824,-1646.0
37972,65112,36719,6828,32470,4249,172,0,2751.0
40884,110910,88312,21677,46562,41750,17786,1104,-3391.0
44758,110329,81530,18824,50116,31414,10097,372,-2865.0
48236,94713,59399,12052,46486,12913,1741,10,870.0
9892,15160,7741,1317,7580,161,0,0,1156.0
46725,87266,52671,10360,43182,9489,902,3,1770.0
45025,110229,80999,18613,50320,30679,9589,341,-2818.0
42421,110888,85699,20527,48236,37463,14416,775,-3295.0
36679,108825,95879,25874,36514,59365,35797,4447,-2141.0
48222,101869,67371,14250,49242,18129,3385,32,-526.0
41012,70929,40287,7538,35346,4941,237,2,2832.0
35625,106210,99458,29044,24652,74806,56906,11315,-171.0
4908,7448,3767,635,3724,43,0,0,592.0
48357,104188,69868,14939,50102,19766,3984,59,-902.0
46961,107479,75243,16639,50652,24591,6175,137,-1914.0
39154,67079,37803,7026,33450,4353,179,0,2852.0
48437,96207,60841,12425,47132,13709,1943,13,646.0
39984,68834,38957,7268,34306,4651,222,0,2839.0
37068,109208,94974,25284,38244,56730,32720,3724,-2450.0
45766,109493,79171,17967,50540,28631,8413,272,-2523.0
45276,109709,79892,18207,50542,29350,8625,230,-2748.0
15046,23381,12097,2084,11690,407,1,0,1678.0
46528,87007,52564,10347,43046,9518,915,6,1738.0
48125,103580,69454,14854,49784,19670,4012,51,-855.0
35621,106105,99637,29234,23870,75767,58365,11913,-81.0
48063,92618,57254,11481,45622,11632,1374,5,1218.0
38226,65053,36456,6743,32454,4002,145,0,2886.0
48377,102863,68315,14494,49666,18649,3531,41,-665.0
35812,104789,100950,31409,13446,87504,77897,21238,564.0
47991,92575,57223,11467,45644,11579,1287,3,1172.0
35656,106307,99338,28935,25066,74272,56175,11086,-248.0
38310,65459,36820,6834,32636,4184,187,0,2837.0
46255,107584,76174,16991,50402,25772,6780,145,-2146.0
23882,38209,20304,3585,19098,1206,13,0,2392.0
47368,107763,75118,16553,50918,24200,5927,110,-1830.0
48206,102403,67965,14413,49452,18513,3499,44,-645.0
37017,109057,95131,25422,37730,57401,33597,3949,-2331.0
45662,109614,79417,18045,50564,28853,8486,258,-2580.0
46463,108824,77419,17334,50834,26585,7156,181,-2276.0
37120,109189,95001,25309,38148,56853,32893,3726,-2377.0
36346,108294,96657,26483,34416,62241,39462,5478,-1774.0
40292,69444,39329,7340,34618,4711,208,0,2837.0
35587,106583,99110,28578,26752,72358,53079,9763,-464.0
48285,103309,68968,14698,49748,19220,3813,45,-754.0
45699,109395,79007,17895,50644,28363,8107,223,-2584.0
48128,93488,58140,11715,45990,12150,1508,8,1065.0
32242,52865,28712,5170,26404,2308,57,0,2919.0
23158,36651,19288,3376,18320,968,11,0,2419.0
48416,104184,69773,14899,50152,19621,3880,52,-894.0
47431,91063,56153,11241,44860,11293,1343,11,1280.0
45277,109538,79812,18212,50352,29460,8834,247,-2661.0
38739,110301,92402,23755,42274,50128,25753,2295,-2915.0
47265,107344,74811,16493,50664,24147,6016,123,-1761.0
36181,108134,96966,26672,33900,63066,40334,5599,-1659.0
47601,106316,73118,15942,50584,22534,5148,95,-1539.0
38850,110487,91812,23385,43314,48498,23859,1956,-3210.0
46846,106579,74212,16330,50444,23768,5691,104,-1851.0
23284,37044,19587,3443,18516,1071,12,0,2384.0
35742,107213,98148,27717,29994,68154,47225,7828,-1040.0
38030,65087,36648,6806,32460,4188,167,0,2785.0
43744,110250,82621,19268,49634,32987,10982,416,-3153.0
43852,78772,46113,8845,39156,6957,460,0,2348.0
43437,109977,82800,19389,49266,33534,11445,429,-3129.0
26686,42941,22941,4071,21456,1485,29,0,2615.0
19020,29862,15600,2712,14928,672,6,0,2046.0
46639,108698,77060,17205,50890,26170,6918,157,-2204.0
38268,110268,93145,24108,41642,51503,26984,2552,-2963.0
46159,109104,78148,17593,50738,27410,7628,201,-2390.0
42998,76459,44424,8472,38016,6408,427,0,2491.0
47417,106170,73118,15956,50500,22618,5170,99,-1591.0
42308,74505,42949,8137,37076,5873,353,2,2615.0
38608,110536,92625,23791,42504,50121,25528,2292,-3094.0
35784,104864,100919,31261,14272,86647,76320,20356,578.0
46397,86507,52152,10249,42810,9342,887,1,1793.0
32688,53998,29515,5344,26966,2549,66,0,2861.0
45019,109717,80257,18364,50330,29927,9057,299,-2805.0
9918,15137,7699,1305,7568,131,1,0,1175.0
40298,110990,89684,22314,45484,44200,20022,1458,-3322.0
44358,80895,47934,9288,40140,7794,615,0,2109.0
36304,108209,96742,26549,34190,62552,39829,5538,-1712.0
36766,108917,95594,25688,37060,58534,34797,4196,-2245.0
36821,108849,95518,25688,36908,58610,35033,4309,-2198.0
48377,96104,60751,12398,47114,13637,1876,11,626.0
47347,106101,73081,15944,50498,22583,5105,83,-1617.0
44855,109790,80625,18508,50202,30423,9386,289,-2818.0
35676,105441,100207,30119,19700,80507,66041,15330,323.0
36324,108120,96879,26684,33654,63225,40812,5872,-1601.0
43631,111118,84066,19769,49518,34548,12082,493,-3190.0
10640,16288,8308,1412,8144,164,0,0,1248.0
42284,110993,86043,20652,48174,37869,14645,746,-3318.0
35847,107201,98192,27764,29800,68392,47601,7899,-926.0
45569,109319,79176,17988,50424,28752,8471,269,-2562.0
47529,90959,55945,11174,44846,11099,1267,1,1341.0
39394,110786,90894,22876,44532,46362,21722,1610,-3374.0
10214,15653,7993,1360,7826,167,1,0,1194.0
13932,21512,11063,1895,10756,307,0,0,1588.0
40333,111049,89786,22350,45472,44314,20105,1421,-3280.0
35982,107489,97822,27444,30980,66842,45529,7260,-1129.0
47921,92572,57366,11531,45546,11820,1480,7,1184.0
24676,39426,20926,3691,19706,1220,14,0,2485.0
32942,54461,29789,5397,27196,2593,69,0,2873.0
44784,110418,81553,18812,50234,31319,9950,336,-2893.0
48168,105670,71774,15500,50548,21226,4574,76,-1228.0
46773,87673,53058,10458,43368,9690,937,5,1700.0
48870,98615,63067,12990,48194,14873,2227,12,332.0
47385,106737,73850,16175,50650,23200,5437,89,-1677.0
37288,109557,94869,25157,38796,56073,31965,3606,-2557.0
48031,92920,57582,11566,45768,11814,1384,9,1127.0
29894,48839,26440,4747,24398,2042,43,0,2748.0
42558,74727,42964,8120,37208,5756,311,0,2675.0
35582,105529,100180,29963,20582,79598,64365,14460,270.0
19620,30698,15986,2771,15346,640,6,0,2137.0
37390,109417,94362,24922,39192,55170,31033,3372,-2587.0
19070,29949,15649,2721,14972,677,5,0,2049.0
40386,69785,39610,7407,34778,4832,229,0,2804.0
36436,108414,96552,26406,34668,61884,39078,5432,-1832.0
40986,71529,40926,7704,35628,5298,273,0,2679.0
43698,110558,83182,19468,49556,33626,11446,434,-3146.0
44444,110120,81820,18984,49736,32084,10648,388,-2840.0
33010,54507,29785,5392,27218,2567,71,0,2896.0
44231,110117,81844,18969,49874,31970,10369,379,-3011.0
36625,108859,96057,25953,36396,59661,36067,4489,-2130.0
48765,98266,62795,12928,48022,14773,2222,11,366.0
39662,111083,90951,22864,44718,46233,21647,1612,-3334.0
48504,101484,66592,13992,49232,17360,3020,32,-380.0
40321,110998,89442,22171,45858,43584,19282,1275,-3406.0
46423,108506,77000,17197,50818,26182,6870,165,-2280.0
39298,111013,91518,23134,44232,47286,22549,1728,-3331.0
40902,71049,40511,7606,35386,5125,277,0,2758.0
37206,109547,94927,25184,38750,56177,32047,3652,-2598.0
48051,106214,72485,15704,50746,21739,4722,69,-1382.0
40204,111040,89897,22388,45466,44431,20108,1392,-3327.0
45738,109687,79435,18043,50612,28823,8463,240,-2557.0
47849,105141,71478,15442,50304,21174,4533,57,-1256.0
42270,111037,85894,20557,48446,37448,14145,684,-3430.0
37178,109122,94618,25130,38456,56162,32210,3634,-2456.0
45629,110067,79954,18197,50726,29228,8615,265,-2681.0
48295,101488,66819,14079,49164,17655,3160,37,-453.0
48593,100244,65142,13588,48756,16386,2732,31,-97.0
38794,110564,92165,23555,43000,49165,24564,2114,-3160.0
35746,107112,98332,27877,29402,68930,48308,8166,-911.0
44853,109852,80779,18573,50120,30659,9612,319,-2793.0
48328,94547,59150,11981,46414,12736,1719,14,950.0
40199,110901,89636,22293,45514,44122,19873,1403,-3359.0
47941,93356,58143,11726,45930,12213,1496,7,1002.0
46804,107479,75402,16698,50616,24786,6247,130,-1971.0
38447,110124,92492,23822,42052,50440,26020,2409,-3007.0
44705,110274,81454,18791,50162,31292,9950,355,-2906.0
37399,109584,94631,25036,39046,55585,31492,3533,-2590.0
48611,101714,66820,14062,49268,17552,3178,33,-345.0
45833,109190,78533,17723,50728,27805,7734,199,-2547.0
37381,63191,35226,6488,31524,3702,143,1,2928.0
38962,66611,37483,6959,33212,4271,187,0,2875.0
45207,110123,80511,18412,50550,29961,9023,291,-2817.0
42488,110330,84833,20229,48292,36541,13746,672,-3238.0
39261,110824,91504,23190,43868,47636,23088,1891,-3249.0
39759,110853,90609,22768,44610,45999,21633,1655,-3253.0
46145,84494,50240,9765,41890,8350,714,3,2126.0
38379,110057,92443,23802,42074,50369,25909,2379,-3037.0
48289,101778,67181,14187,49240,17941,3298,39,-495.0
45527,82910,49100,9514,41116,7984,678,5,2203.0
36645,108551,96171,26163,35364,60807,37823,5077,-1898.0
38850,110522,91827,23387,43332,48495,23858,1982,-3232.0
38125,109900,93124,24210,40988,52136,27924,2859,-2861.0
44310,110515,82198,19058,50048,32150,10419,392,-3065.0
35598,105454,100097,29956,20458,79639,64538,14570,285.0
45568,109755,79593,18082,50694,28899,8367,226,-2676.0
43245,110814,84277,19909,49100,35177,12614,547,-3201.0
43118,110722,84272,19913,49066,35206,12590,542,-3245.0
38619,110526,92586,23774,42528,50058,25470,2281,-3095.0
48477,97330,61995,12726,47634,14361,2062,11,416.0
46452,108070,76539,17082,50586,25953,6898,188,-2161.0
42074,111359,86813,20934,48022,38791,15315,864,-3406.0
47262,107672,75143,16577,50824,24319,6024,126,-1844.0
47631,92635,57656,11624,45568,12088,1499,7,1028.0
45416,109764,79947,18247,50412,29535,8940,300,-2648.0
36612,108709,96130,26057,35918,60212,36873,4742,-2024.0
43869,110430,82855,19359,49556,33299,11318,443,-3065.0
46602,108864,77373,17320,50826,26547,7212,194,-2209.0
38174,64877,36331,6718,32354,3977,169,0,2910.0
48186,95435,60167,12249,46840,13327,1755,8,669.0
26776,43194,23125,4111,21584,1541,26,0,2596.0
39873,110657,90185,22612,44698,45487,21261,1597,-3211.0
35668,106661,98911,28445,27152,71759,52357,9570,-527.0
21710,34229,17949,3131,17112,837,5,0,2299.0
46433,85800,51377,10043,42496,8881,808,3,1967.0
46913,108405,76391,16977,50920,25471,6565,149,-2078.0
39797,110750,90236,22595,44902,45334,20946,1519,-3312.0
48647,101380,66345,13912,49218,17127,2944,29,-300.0
47534,106546,73405,16018,50702,22703,5142,82,-1625.0
46117,84745,50515,9836,42014,8501,717,1,2051.0
45528,110236,80291,18313,50704,29587,8828,284,-2730.0
47641,92830,57820,11659,45686,12134,1458,11,972.0
37174,62653,34841,6404,31258,3583,137,0,2958.0
45826,84639,50633,9885,41956,8677,727,0,1935.0
38489,110486,92770,23867,42338,50432,25810,2339,-3094.0
38966,110659,91723,23313,43568,48155,23523,1964,-3283.0
34516,57428,31581,5748,28674,2907,80,0,2921.0
37154,62839,35045,6457,31348,3697,143,0,2903.0
44486,80203,47094,9057,39846,7248,511,0,2320.0
46595,87384,52942,10450,43184,9758,1016,5,1703.0
48140,105487,71587,15447,50492,21095,4503,62,-1207.0
47700,93149,58144,11748,45800,12344,1549,6,947.0
48155,104124,69884,14936,50152,19732,3820,45,-1021.0
12022,18469,9453,1612,9234,219,1,0,1394.0
37392,63306,35333,6514,31582,3751,142,0,2905.0
47295,107356,74693,16433,50788,23905,5780,109,-1801.0
48548,102548,67794,14335,49578,18216,3392,52,-541.0
48562,95886,60352,12276,47048,13304,1790,10,752.0
38049,110154,93465,24284,41226,52239,27702,2671,-2924.0
36277,108155,96920,26689,33706,63214,40743,5865,-1647.0
36766,109002,95502,25628,37236,58266,34530,4254,-2362.0
45213,110037,80473,18416,50450,30023,9137,297,-2767.0
43718,110130,82757,19375,49264,33493,11602,514,-3030.0
45936,84285,50200,9771,41774,8426,737,2,2080.0
37182,62879,35056,6456,31376,3680,127,0,2903.0
42569,111241,85832,20509,48610,37222,14021,657,-3349.0
35902,107395,97761,27427,30960,66801,45475,7260,-1159.0
43226,76618,44410,8454,38096,6314,426,2,2564.0
42280,111353,86439,20761,48312,38127,14729,758,-3395.0
35878,60471,33620,6177,30178,3442,115,0,2850.0
42086,110858,86059,20673,48080,37979,14698,778,-3386.0
35814,104746,101014,31566,12632,88382,79482,22150,516.0
48815,98374,62830,12926,48104,14726,2166,21,345.0
35751,105087,100605,30746,16734,83871,71619,17971,523.0
47624,105021,71585,15499,50176,21409,4669,70,-1311.0
47428,106972,74048,16225,50746,23302,5480,124,-1721.0
44525,80610,47511,9169,40008,7503,594,3,2257.0
45925,84856,50788,9921,42050,8738,756,3,1936.0
41794,73276,42089,7950,36478,5611,320,2,2657.0
47808,104619,70956,15307,50070,20886,4479,62,-1162.0
19580,30766,16084,2798,15380,704,6,0,2100.0
39777,110752,90219,22583,44940,45279,20872,1515,-3339.0
40516,70440,40177,7543,35096,5081,248,0,2710.0
12844,19790,10158,1737,9894,264,2,0,1475.0
40800,111084,88707,21825,46464,42243,18156,1140,-3402.0
46689,108304,76511,17036,50806,25705,6692,163,-2140.0
41318,71979,41126,7733,35854,5272,271,0,2732.0
45553,108849,78564,17793,50370,28194,8109,233,-2525.0
43342,110487,83712,19716,49128,34584,12231,512,-3149.0
46034,84975,50833,9927,42104,8729,767,0,1965.0
37115,109333,95110,25330,38240,56870,32853,3751,-2438.0
45491,110261,80504,18415,50518,29986,9225,335,-2681.0
46299,109425,78442,17675,50834,27608,7757,183,-2359.0
41118,110973,88130,21602,46648,41482,17677,1124,-3327.0
34922,58083,31939,5814,28994,2945,95,0,2964.0
25630,41307,22098,3926,20640,1458,27,0,2495.0
48239,92896,57415,11514,45746,11669,1404,5,1244.0
48776,97596,62068,12734,47732,14336,2132,16,514.0
47881,105346,71681,15499,50368,21313,4610,79,-1283.0
46838,88297,53688,10625,43626,10062,1045,4,1604.0
39282,110893,91424,23128,44080,47344,22733,1832,-3315.0
48198,103616,69351,14802,49890,19461,3836,46,-869.0
43595,111051,84107,19805,49384,34723,12283,519,-3154.0
43017,111158,84978,20155,49026,35952,13106,627,-3318.0
39320,110743,91004,22944,44344,46660,22055,1702,-3363.0
46852,107605,75556,16752,50600,24956,6405,150,-1949.0
48032,102331,68042,14447,49402,18640,3527,38,-704.0
3092,4656,2337,391,2328,9,0,0,382.0
41344,110940,87363,21233,47328,40035,16284,948,-3466.0
36411,108123,96875,26689,33616,63259,40891,5847,-1526.0
44682,81436,48229,9341,40412,7817,612,2,2134.0
28554,46201,24804,4421,23082,1722,37,0,2736.0
41060,110969,88014,21528,46860,41154,17249,1046,-3423.0
25364,40536,21519,3796,20262,1257,12,0,2551.0
47903,93219,58081,11725,45812,12269,1595,11,1040.0
45847,85165,51196,10038,42164,9032,837,3,1840.0
47819,93767,58685,11880,46090,12595,1587,15,857.0
39121,67297,38054,7093,33550,4504,197,1,2785.0
4220,6396,3231,544,3198,33,0,0,511.0
48576,97001,61569,12608,47490,14079,2021,14,536.0
44365,79879,46864,9008,39680,7184,519,1,2342.0
44654,79853,46603,8920,39686,6917,481,0,2484.0
47135,107620,75178,16590,50816,24362,5988,113,-1897.0
41881,111269,87063,21063,47748,39315,15773,909,-3388.0
40905,111196,88303,21585,47096,41207,17004,955,-3573.0
38062,110117,93247,24185,41384,51863,27349,2664,-2993.0
35601,106275,99412,28972,24992,74420,56291,11077,-234.0
43573,110656,83505,19596,49434,34071,11788,487,-3174.0
27146,43769,23424,4163,21870,1554,29,0,2638.0
30548,49980,27091,4869,24968,2123,44,0,2790.0
38925,110588,91579,23233,43760,47819,23068,1799,-3317.0
35607,106498,99087,28647,26292,72795,53914,10217,-451.0
48718,101551,66481,13946,49286,17195,2979,28,-298.0
48298,104011,69739,14911,50012,19727,3987,56,-885.0
8192,12472,6328,1070,6236,92,0,0,978.0
44371,110689,82557,19204,49890,32667,10909,411,-2965.0
47614,105416,72005,15611,50344,21661,4728,86,-1408.0
48609,94352,58606,11792,46460,12146,1432,7,1071.0
33874,56095,30733,5577,28004,2729,87,0,2935.0
48468,95746,60276,12262,46980,13296,1786,16,736.0
35721,105312,100500,30463,18222,82278,68868,16607,446.0
48516,100154,65155,13607,48668,16487,2818,28,-90.0
48394,103832,69454,14824,49964,19490,3904,46,-808.0
48172,102558,68120,14446,49564,18556,3430,32,-712.0
41220,111167,88002,21488,47076,40926,17015,1010,-3433.0
35696,106154,99592,29218,23876,75716,58402,11988,-84.0
47889,92894,57717,11622,45702,12015,1490,7,1090.0
48233,105161,71102,15296,50428,20674,4305,49,-1122.0
48161,106378,72582,15728,50796,21786,4786,91,-1363.0
47414,106745,73897,16203,50576,23321,5593,112,-1637.0
48221,98588,63639,13202,48066,15573,2456,15,70.0
46694,107582,75626,16774,50608,25018,6366,158,-2036.0
42912,110840,84692,20072,48952,35740,12936,576,-3308.0
48441,103089,68530,14554,49736,18794,3617,49,-672.0
47035,107360,75022,16569,50630,24392,6100,149,-1872.0
48611,101131,66129,13862,49086,17043,2959,31,-253.0
48264,94872,59506,12069,46598,12908,1676,8,829.0
46987,106961,74623,16459,50492,24131,5977,115,-1810.0
37984,64648,36244,6708,32240,4004,168,0,2872.0
43011,110789,84513,20013,48948,35565,12893,619,-3278.0
38730,110447,92214,23620,42708,49506,25031,2268,-3123.0
45371,109848,80076,18280,50472,29604,8904,261,-2681.0
38708,110463,92502,23749,42510,49992,25443,2202,-3002.0
35612,106137,99381,29045,24492,74889,57153,11498,-189.0
37020,109197,95138,25383,37978,57160,33241,3886,-2422.0
38072,109976,93043,24101,41480,51563,27016,2516,-2962.0
37189,109405,94927,25210,38594,56333,32217,3593,-2499.0
42049,110854,86241,20767,47880,38361,15094,831,-3331.0
36796,62296,34771,6411,31076,3695,144,0,2860.0
43584,77412,44932,8561,38498,6434,416,0,2543.0
49021,97524,61719,12608,47790,13929,1944,15,608.0
35664,105677,100082,29867,20962,79120,63753,14298,202.0
48689,102297,67297,14164,49610,17687,3077,29,-475.0
28368,46074,24817,4436,23018,1799,38,0,2675.0
3680,5544,2784,466,2772,12,0,0,454.0
45503,110152,80280,18325,50610,29670,8932,281,-2694.0
42889,76539,44589,8521,38052,6537,435,1,2418.0
47450,106441,73507,16086,50498,23009,5445,92,-1570.0
35808,107126,98210,27812,29548,68662,48030,8100,-920.0
38842,110560,92244,23603,42870,49374,24820,2126,-3077.0
38993,110504,91393,23169,43772,47621,22960,1795,-3287.0
45438,83228,49482,9614,41280,8202,668,2,2078.0
45918,84768,50702,9899,42010,8692,748,2,1953.0
48175,97187,62108,12782,47524,14584,2139,23,314.0
45758,108877,78364,17709,50474,27890,7929,212,-2464.0
48328,93608,58087,11684,46070,12017,1468,12,1123.0
48135,104440,70348,15090,50156,20192,4128,73,-1047.0
8744,13340,6782,1149,6670,112,0,0,1037.0
36161,108083,97074,26783,33450,63624,41183,5973,-1631.0
43674,110538,83418,19600,49236,34182,12066,530,-3046.0
36082,60763,33755,6197,30328,3427,107,0,2877.0
36164,108075,97231,26867,33260,63971,41555,5998,-1547.0
35874,104666,101134,31813,11390,89744,81886,23426,529.0
12990,19977,10235,1747,9988,247,1,0,1501.0
39838,110855,90222,22560,45084,45138,20687,1464,-3355.0
44131,110145,82041,19044,49818,32223,10509,347,-3017.0
47660,106007,72676,15802,50540,22136,4927,66,-1473.0
44196,79958,47076,9073,39714,7362,530,0,2241.0
42221,74171,42660,8065,36930,5730,311,1,2645.0
35681,107082,98517,27998,29046,69471,48990,8399,-882.0
37204,109391,94930,25239,38426,56504,32539,3770,-2496.0
46845,108738,76889,17136,50962,25927,6814,163,-2140.0
36572,108758,96219,26092,35886,60333,36986,4804,-2059.0
36195,108179,97041,26730,33702,63339,40775,5839,-1673.0
44188,79122,46210,8848,39332,6878,458,0,2428.0
14674,22753,11748,2020,11376,372,1,0,1649.0
28868,46736,25101,4475,23352,1749,32,0,2758.0
47283,107311,74654,16426,50752,23902,5807,131,-1800.0
35788,104827,100954,31341,13862,87092,77103,20778,574.0
35738,105033,100722,30899,16050,84672,72933,18632,528.0
46234,86175,51948,10210,42636,9312,903,4,1797.0
45454,83009,49245,9552,41178,8067,653,0,2138.0
39762,68249,38526,7171,34026,4500,197,0,2868.0
48662,100718,65641,13727,48920,16721,2878,26,-142.0
27085,43857,23559,4201,21912,1647,33,1,2586.0
36644,108747,95961,25961,36156,59805,36435,4694,-2103.0
47806,106822,73545,16057,50748,22797,5326,114,-1528.0
35632,105597,100082,29885,20854,79228,63889,14314,232.0
36520,108444,96608,26437,34594,62014,39256,5432,-1753.0
38594,110334,92458,23770,42296,50162,25742,2402,-3052.0
35752,104974,100731,30957,15720,85011,73534,18928,552.0
41269,71651,40842,7667,35682,5160,287,1,2793.0
39439,110822,91240,23068,44072,47168,22678,1789,-3211.0
40446,111035,89281,22092,46010,43271,19015,1236,-3400.0
35567,106281,99366,28906,25296,74070,55689,10779,-254.0
42986,75871,43839,8325,37728,6111,415,0,2629.0
48474,99003,63901,13262,48230,15671,2543,24,110.0
11158,17081,8713,1481,8540,173,1,0,1309.0
40444,111068,89145,22013,46212,42933,18644,1216,-3492.0
42042,110980,86448,20841,47850,38598,15280,854,-3331.0
35820,104771,101013,31499,13032,87981,78707,21662,563.0
12992,20042,10299,1763,10020,279,2,0,1486.0
48334,96118,60787,12407,47132,13655,1854,10,596.0
46503,107963,76356,17022,50580,25776,6803,175,-2126.0
40454,111174,89417,22132,46042,43375,19090,1282,-3435.0
46942,107914,75730,16770,50840,24890,6234,126,-2012.0
19894,31319,16400,2857,15658,742,3,0,2118.0
35779,104858,100887,31240,14334,86553,76190,20309,568.0
48420,100813,65970,13839,48906,17064,3001,38,-262.0
43458,110108,82959,19444,49254,33705,11600,474,-3135.0
36630,61603,34188,6272,30744,3444,115,0,2943.0
46313,85843,51531,10094,42498,9033,847,1,1907.0
35674,105566,100272,30068,20136,80136,65294,14914,312.0
47287,106657,73924,16225,50498,23426,5661,131,-1671.0
46875,88615,54028,10721,43730,10298,1155,11,1567.0
5600,8476,4276,719,4238,38,0,0,681.0
41045,111115,88283,21625,46816,41467,17483,1053,-3412.0
48960,99883,64361,13332,48730,15631,2423,18,106.0
43701,110960,83872,19725,49394,34478,12172,531,-3112.0
39385,110723,91023,22970,44226,46797,22271,1729,-3285.0
45803,108850,78201,17638,50574,27627,7702,197,-2484.0
20242,31857,16678,2905,15926,752,5,0,2158.0
48276,104149,69924,14965,50058,19866,4033,46,-914.0
44868,109276,80091,18375,49932,30159,9412,320,-2692.0
42891,110984,85080,20238,48732,36348,13520,661,-3251.0
37860,64324,36019,6661,32072,3947,180,0,2894.0
47557,106601,73454,16034,50704,22750,5193,101,-1624.0
44475,110154,81620,18880,49960,31660,10234,393,-2939.0
37591,109723,94367,24852,39622,54745,30479,3203,-2617.0
44048,110418,82639,19280,49598,33041,11222,472,-3011.0
44428,80438,47402,9145,39934,7468,570,0,2247.0
39126,110605,91558,23266,43520,48038,23565,1980,-3187.0
43516,110792,83880,19747,49278,34602,12236,524,-3143.0
39505,110726,90876,22917,44250,46626,22226,1779,-3262.0
46355,85945,51587,10102,42562,9025,821,3,1895.0
48210,93282,57838,11626,45920,11918,1442,10,1140.0
47327,88978,53924,10634,44044,9880,890,5,1639.0
47206,107028,74485,16403,50552,23933,5924,134,-1740.0
39959,110922,90099,22496,45222,44877,20478,1457,-3360.0
45478,108809,78653,17839,50272,28381,8265,240,-2517.0
36047,107672,97437,27133,32076,65361,43520,6613,-1321.0
35975,107597,97937,27456,31138,66799,45321,7119,-1141.0
38252,110075,92908,24022,41684,51224,26707,2442,-2937.0
44522,110127,81414,18782,50136,31278,9855,332,-2973.0
48636,102635,67781,14316,49666,18115,3303,38,-534.0
47536,106922,73902,16175,50754,23148,5414,100,-1659.0
45021,109948,80601,18477,50340,30261,9268,287,-2803.0
48256,96938,61852,12726,47348,14504,2242,20,444.0
40142,69193,39195,7317,34488,4707,217,0,2827.0
16914,26379,13695,2367,13188,507,3,0,1863.0
35688,59982,33271,6101,29936,3335,110,0,2876.0
27686,44907,24158,4313,22438,1720,31,0,2624.0
45380,109422,79481,18088,50434,29047,8554,244,-2649.0
47296,106007,72976,15907,50510,22466,4987,70,-1642.0
43670,78263,45760,8773,38882,6878,499,0,2394.0
35601,106113,99691,29268,23774,75917,58565,12005,-89.0
40877,71223,40702,7655,35474,5228,275,1,2701.0
35883,107520,97740,27349,31386,66354,44748,6989,-1246.0
41308,111160,87684,21334,47364,40320,16432,948,-3502.0
47266,89704,54798,10882,44304,10494,1096,6,1478.0
41371,111412,88159,21528,47150,41009,17112,1041,-3410.0
43304,77430,45209,8660,38458,6751,514,0,2423.0
46635,87470,52989,10457,43236,9753,998,5,1697.0
42874,111346,85614,20415,48738,36876,13870,682,-3273.0
35590,106386,99129,28698,26070,73059,54246,10250,-365.0
44768,110153,81111,18656,50286,30825,9581,342,-2930.0
29458,48035,25959,4653,24000,1959,35,0,2729.0
44005,110963,83310,19468,49812,33498,11339,425,-3116.0
12756,19720,10153,1741,9860,293,0,0,1448.0
47823,94007,59004,11980,46128,12876,1751,15,840.0
48352,98362,63246,13080,48012,15234,2338,28,156.0
43626,110663,83707,19711,49148,34559,12367,560,-3041.0
35688,105143,100610,30680,17140,83470,70863,17598,475.0
48364,103500,69070,14711,49874,19196,3752,44,-777.0
48492,101568,66735,14042,49218,17517,3132,40,-383.0
47733,106328,73079,15939,50524,22555,5280,119,-1455.0
48769,99712,64394,13368,48580,15814,2552,23,83.0
45593,109283,79063,17943,50468,28595,8347,265,-2570.0
47077,106772,74338,16379,50402,23936,5968,147,-1736.0
36416,108270,96739,26563,34100,62639,40070,5672,-1678.0
47891,94175,59102,11995,46234,12868,1707,11,823.0
44355,110600,82447,19168,49886,32561,10828,401,-2966.0
48375,101061,66294,13933,48990,17304,3081,35,-325.0
44906,109768,80518,18468,50228,30290,9312,302,-2812.0
48253,94792,59417,12043,46576,12841,1640,7,835.0
40619,110996,88690,21818,46472,42218,18052,1157,-3505.0
35627,106515,99180,28720,26040,73140,54435,10443,-428.0
46008,108707,77816,17504,50608,27208,7491,174,-2387.0
43261,111019,84285,19857,49428,34857,12163,493,-3330.0
40930,71369,40800,7674,35556,5244,257,0,2687.0
45242,108743,78806,17905,50182,28624,8379,260,-2600.0
47800,105894,72397,15711,50528,21869,4838,88,-1408.0
48270,104563,70323,15061,50280,20043,4003,52,-1031.0
30338,49423,26693,4783,24688,2005,47,0,2825.0
8440,12920,6590,1120,6460,130,0,0,990.0
36781,109000,95838,25821,36750,59088,35500,4435,-2202.0
37972,64626,36232,6706,32228,4004,170,0,2872.0
35938,104543,101340,32625,6930,94410,90683,28788,110.0
31728,51954,28181,5068,25954,2227,46,0,2887.0
46840,106044,73644,16182,50196,23448,5652,128,-1742.0
35861,104668,101076,31775,11502,89574,81664,23371,494.0
44396,110389,81905,18946,50134,31771,10121,330,-3034.0
48572,97400,62031,12739,47628,14403,2144,16,464.0
41316,72213,41385,7804,35946,5439,321,2,2684.0
36417,108443,96873,26573,34308,62565,39827,5561,-1726.0
48615,103133,68408,14503,49798,18610,3537,43,-613.0
48513,99338,64189,13326,48422,15767,2494,15,38.0
35544,106103,99460,29075,24470,74990,57163,11422,-174.0
46589,87036,52564,10347,43046,9518,944,3,1770.0
48175,106263,72441,15688,50754,21687,4755,91,-1335.0
48587,102050,67216,14173,49394,17822,3262,33,-420.0
32370,53259,29007,5235,26604,2403,51,0,2883.0
48191,105601,71717,15492,50482,21235,4637,79,-1185.0
45287,109298,79364,18047,50446,28918,8406,229,-2694.0
31222,51171,27776,4998,25564,2212,43,0,2829.0
35738,105096,100636,30758,16724,83912,71648,17974,520.0
38537,110475,92662,23820,42404,50258,25667,2325,-3096.0
45256,109131,79265,18036,50314,28951,8503,234,-2646.0
36863,109031,95621,25690,37102,58519,34827,4235,-2237.0
36084,108053,97195,26849,33296,63899,41461,6034,-1623.0
38278,110035,92905,24056,41474,51431,27087,2620,-2908.0
42456,111119,85842,20532,48492,37350,14135,670,-3353.0
48136,105374,71441,15403,50464,20977,4446,72,-1200.0
18510,28897,15017,2598,14446,571,5,0,2032.0
37501,109767,94248,24766,39900,54348,29967,3169,-2784.0
45860,109503,79111,17943,50564,28547,8375,246,-2475.0
30284,49504,26815,4817,24728,2087,48,0,2778.0
22036,34788,18265,3190,17390,875,8,0,2323.0
44450,110434,82026,19007,50010,32016,10414,370,-2965.0
47783,92434,57294,11512,45516,11778,1402,5,1131.0
39019,110791,92043,23461,43320,48723,24151,2079,-3190.0
2620,3952,1987,333,1976,11,0,0,322.0
47680,103916,70189,15084,49874,20315,4168,68,-1131.0
35627,105754,99913,29658,21878,78035,61998,13493,128.0
48435,104493,70106,14992,50260,19846,3973,63,-944.0
48381,96134,60818,12425,47086,13732,1962,15,640.0
39620,110679,90371,22660,44782,45589,21115,1534,-3348.0
48972,100319,64806,13447,48930,15876,2459,18,12.0
35030,58373,32149,5860,29138,3011,97,0,2946.0
36022,107905,97559,27112,32446,65113,43013,6448,-1436.0
31540,51702,28072,5053,25826,2246,50,0,2857.0
48857,100898,65676,13726,48996,16680,2906,43,-91.0
48783,102960,67961,14342,49870,18091,3220,29,-558.0
35868,104695,101110,31777,11558,89552,81579,23298,506.0
35806,107031,98428,28000,28856,69572,49319,8544,-797.0
46080,108880,77906,17518,50704,27202,7472,200,-2412.0
44126,110683,82808,19301,49810,32998,11063,416,-3050.0
46165,108422,77293,17334,50582,26711,7258,179,-2298.0
47331,106886,74138,16278,50608,23530,5670,113,-1695.0
43251,110781,84185,19875,49120,35065,12541,571,-3220.0
47595,106242,73010,15902,50608,22402,5026,65,-1539.0
34234,56953,31320,5701,28434,2886,85,0,2900.0
36144,61038,33993,6255,30456,3537,126,0,2844.0
42495,110757,85146,20270,48672,36474,13413,595,-3386.0
46972,88376,53677,10616,43658,10019,1060,0,1657.0
36176,108064,97279,26921,33032,64247,42000,6204,-1530.0
41654,111034,87091,21106,47546,39545,15942,898,-3395.0
45561,110303,80425,18366,50654,29771,8995,273,-2683.0
47161,88862,53988,10674,43932,10056,998,3,1613.0
44523,110131,81558,18855,49986,31572,10159,347,-2905.0
4704,7124,3596,605,3562,34,0,0,571.0
45278,110398,80757,18473,50676,30081,9046,274,-2836.0
39598,110881,91044,22974,44244,46800,22393,1780,-3213.0
44204,79952,47077,9076,39698,7379,556,0,2253.0
36315,108378,96815,26539,34396,62419,39586,5493,-1787.0
35472,59582,33033,6055,29736,3297,110,0,2868.0
40709,70843,40442,7599,35290,5152,263,1,2709.0
45770,109453,79086,17931,50586,28500,8281,240,-2528.0
48686,100749,65610,13706,48984,16626,2781,20,-159.0
39472,110866,91129,23003,44240,46889,22386,1768,-3268.0
44873,110061,80951,18610,50242,30709,9577,325,-2847.0
42580,110861,85386,20387,48450,36936,13961,694,-3282.0
48160,102479,68054,14432,49516,18538,3447,38,-697.0
45451,109620,79560,18085,50610,28950,8400,229,-2694.0
47646,107581,74522,16335,51034,23488,5513,108,-1748.0
48003,94889,59725,12142,46598,13127,1693,11,697.0
48061,104714,70913,15298,50038,20875,4638,99,-1038.0
48264,102852,68424,14538,49620,18804,3612,48,-702.0
47639,90339,55176,10959,44598,10578,1143,7,1517.0
47944,102838,68713,14647,49544,19169,3750,56,-828.0
45146,81862,48292,9324,40640,7652,582,2,2252.0
47628,90189,54993,10903,44568,10425,1053,2,1529.0
36156,108038,97142,26826,33328,63814,41382,5960,-1566.0
35868,107309,98234,27735,30058,68176,47193,7694,-942.0
43514,110738,83782,19708,49316,34466,12106,498,-3150.0
46015,109526,78845,17820,50770,28075,7986,217,-2486.0
38961,66903,37791,7040,33342,4449,219,1,2809.0
43629,110678,83455,19569,49496,33959,11686,459,-3163.0
22242,35087,18409,3213,17540,869,7,0,2351.0
41801,110988,86612,20889,47890,38722,15208,839,-3464.0
47695,105846,72506,15762,50440,22066,4966,69,-1407.0
15578,24215,12533,2160,12106,427,3,0,1736.0
48300,101218,66504,13989,49074,17430,3070,32,-403.0
48448,94980,59430,12027,46698,12732,1584,8,871.0
40814,111315,88841,21834,46678,42163,17959,1124,-3494.0
37172,109414,94658,25049,39022,55636,31370,3416,-2633.0
43988,110260,82446,19212,49620,32826,11020,444,-3038.0
46662,88020,53520,10588,43512,10008,996,2,1574.0
40751,111326,89219,22021,46312,42907,18702,1193,-3377.0
46161,108914,78045,17592,50538,27507,7838,223,-2300.0
35602,106594,98943,28487,26964,71979,52666,9710,-536.0
43285,110373,83656,19712,49040,34616,12293,533,-3144.0
41334,111256,88079,21523,47020,41059,17216,1046,-3366.0
47894,107706,74491,16317,51080,23411,5546,90,-1638.0
11648,17912,9176,1566,8956,220,0,0,1346.0
48396,94496,58996,11925,46442,12554,1612,12,971.0
36589,108713,96079,26033,35960,60119,36793,4785,-2078.0
43145,76481,44324,8435,38038,6286,405,1,2553.0
37780,64466,36220,6716,32144,4076,178,0,2818.0
41025,110504,87505,21383,46712,40793,17080,1027,-3357.0
41128,111214,88367,21656,46798,41569,17618,1080,-3375.0
41606,111523,87706,21282,47720,39986,16083,872,-3493.0
34102,56621,31091,5653,28264,2827,93,0,2919.0
36260,60520,33373,6089,30212,3161,96,0,3024.0
37859,109880,93676,24468,40544,53132,28792,2941,-2813.0
39323,110547,90759,22866,44322,46437,21903,1663,-3331.0
35596,105986,99670,29319,23426,76244,59134,12248,-39.0
36297,108353,96675,26444,34686,61989,38981,5261,-1825.0
25790,41347,22012,3893,20666,1346,15,0,2562.0
48721,102168,67129,14117,49556,17573,3056,35,-435.0
35688,105400,100312,30209,19370,80942,66660,15536,391.0
47931,92350,57073,11442,45494,11579,1362,13,1212.0
45391,109922,80208,18328,50448,29760,9026,245,-2651.0
47965,93625,58405,11793,46052,12353,1521,9,952.0
47360,106188,73233,16001,50460,22773,5268,92,-1596.0
41716,111225,87161,21097,47740,39421,15745,866,-3445.0
45378,108928,78868,17903,50318,28550,8292,230,-2585.0
48357,100406,65591,13742,48730,16861,2946,27,-200.0
43325,110648,83916,19781,49146,34770,12356,555,-3188.0
45539,83435,49612,9640,41384,8228,667,3,2076.0
15174,23471,12092,2075,11734,358,3,0,1720.0
47627,106314,73104,15939,50574,22530,5166,97,-1522.0
44479,110349,81864,18954,50004,31860,10341,395,-2960.0
21164,33352,17481,3048,16674,807,4,0,2245.0
46323,108272,76864,17175,50678,26186,6916,165,-2260.0
48568,100935,65942,13812,49012,16930,2911,30,-237.0
48548,99577,64415,13384,48526,15889,2525,18,2.0
38394,110553,93029,23970,42238,50791,26077,2356,-3100.0
43170,110550,84054,19856,48972,35082,12606,562,-3182.0
45766,109391,78969,17888,50610,28359,8171,244,-2544.0
24786,39589,21006,3704,19788,1218,13,0,2499.0
41505,111373,87888,21405,47346,40542,16681,929,-3385.0
35553,105553,100159,29935,20708,79451,64137,14397,224.0
47829,106488,73130,15933,50662,22468,5164,91,-1462.0
19584,30794,16111,2805,15392,719,10,0,2096.0
47518,107135,74201,16269,50788,23413,5559,100,-1685.0
47955,93584,58388,11793,46018,12370,1548,5,966.0
5932,9012,4563,770,4506,57,0,0,713.0
45168,109773,80159,18314,50434,29725,8905,254,-2760.0
48243,96076,60883,12455,47036,13847,2004,17,595.0
48403,94809,59304,12001,46602,12702,1605,7,897.0
46278,107506,76114,16988,50300,25814,6906,182,-2102.0
20368,32026,16751,2915,16012,739,2,0,2178.0
48629,102345,67550,14274,49456,18094,3433,53,-440.0
46441,108432,76981,17210,50702,26279,7028,179,-2220.0
35629,105622,100142,29897,20902,79240,63818,14223,252.0
35612,106187,99403,29007,24764,74639,56659,11206,-179.0
42917,110955,84971,20189,48808,36163,13339,621,-3256.0
35936,104546,101344,32603,7070,94274,90406,28604,131.0
48436,96010,60598,12353,47078,13520,1854,16,671.0
38277,110157,92846,23980,41812,51034,26533,2493,-3014.0
46518,85556,51030,9941,42414,8616,728,2,2051.0
36480,108629,96461,26255,35392,61069,37845,4974,-1943.0
36472,108627,96500,26280,35320,61180,37987,5022,-1935.0
48162,95478,60249,12277,46836,13413,1806,14,656.0
42894,75649,43663,8281,37640,6023,369,0,2627.0
44999,110271,81114,18653,50310,30804,9651,311,-2811.0
48647,99832,64635,13443,48612,16023,2608,21,7.0
47607,106987,73947,16192,50742,23205,5503,115,-1625.0
37944,109842,93326,24296,40876,52450,28090,2804,-2868.0
44303,110159,81803,18946,49930,31873,10299,371,-2999.0
35687,105506,100240,30084,19976,80264,65554,15037,337.0
35687,106493,98991,28615,26292,72699,53909,10255,-430.0
47838,92447,57276,11507,45510,11766,1427,8,1160.0
35777,107108,98480,27982,29068,69412,48972,8375,-833.0
35074,58735,32487,5944,29310,3177,115,0,2882.0
38299,110140,92739,23934,41874,50865,26392,2497,-3036.0
36734,108821,95873,25892,36394,59479,36033,4552,-2106.0
36632,61960,34558,6368,30908,3650,144,0,2862.0
17774,27651,14322,2470,13824,498,3,0,1975.0
47667,105737,72428,15749,50362,22066,5013,87,-1391.0
36987,109157,95301,25496,37626,57675,33905,4091,-2365.0
47297,107244,74523,16375,50796,23727,5652,99,-1799.0
35769,104960,100801,31064,15218,85583,74524,19459,546.0
47659,90820,55662,11084,44820,10842,1180,5,1417.0
35788,104873,100890,31274,14136,86754,76601,20590,531.0
46143,86406,52258,10296,42740,9518,926,5,1699.0
41428,72416,41465,7807,36088,5377,240,0,2670.0
44143,110087,81955,19022,49778,32177,10531,387,-3011.0
45130,82652,49155,9556,40974,8181,704,2,2077.0
43410,110898,83983,19753,49448,34535,12002,478,-3258.0
41393,71781,40864,7661,35762,5102,257,1,2815.0
34228,56908,31283,5693,28408,2875,92,0,2910.0
48583,102698,67926,14365,49662,18264,3374,29,-554.0
47989,93681,58482,11821,46038,12444,1605,13,969.0
47823,90681,55361,10989,44788,10573,1105,7,1514.0
48125,104497,70505,15152,50098,20407,4301,65,-1019.0
35707,106972,98474,28006,28912,69562,49148,8389,-797.0
45062,82926,49487,9645,41104,8383,718,2,1978.0
47115,88399,53548,10564,43712,9836,975,3,1700.0
43149,110789,84326,19926,49096,35230,12597,533,-3240.0
42424,74418,42773,8085,37036,5737,346,0,2694.0
39550,68277,38727,7238,34026,4701,225,0,2762.0
17676,27600,14345,2482,13798,547,4,0,1939.0
44345,110473,82223,19091,49900,32323,10673,437,-2996.0
48401,104125,69713,14882,50134,19579,3857,53,-893.0
26588,42752,22825,4048,21362,1463,28,0,2613.0
38306,110223,92870,23968,41932,50938,26359,2404,-3015.0
47483,90282,55269,11000,44538,10731,1206,5,1470.0
43366,110995,84339,19911,49212,35127,12571,556,-3201.0
48104,103761,69568,14863,49958,19610,3845,50,-952.0
41317,110999,87704,21398,47020,40684,16959,1049,-3376.0
46235,109029,77915,17502,50818,27097,7393,179,-2381.0
46257,108449,77084,17234,50764,26320,6921,177,-2342.0
48372,94770,59314,12012,46556,12758,1658,8,904.0
46430,87640,53335,10562,43298,10037,1044,6,1563.0
44924,110604,81541,18775,50432,31109,9740,320,-2914.0
29818,48675,26335,4726,24314,2021,47,0,2752.0
48782,99562,64197,13310,48534,15663,2494,34,107.0
29168,47360,25500,4556,23664,1836,32,0,2752.0
48902,97853,62199,12751,47892,14307,2069,16,497.0
47962,92130,56827,11377,45392,11435,1346,6,1282.0
46319,108767,77540,17388,50752,26788,7263,159,-2296.0
47710,106259,72876,15848,50664,22212,4931,88,-1521.0
46732,87647,53056,10458,43364,9692,919,2,1683.0
35793,104868,100923,31276,14190,86733,76488,20459,572.0
47221,107933,75470,16668,50932,24538,6069,109,-1910.0
35935,104549,101340,32564,7296,94044,89957,28315,162.0
43867,78694,46044,8832,39096,6948,502,1,2385.0
42094,111261,86596,20847,48110,38486,15041,820,-3418.0
48492,99829,64822,13520,48524,16298,2781,38,-35.0
47399,90042,55094,10962,44416,10678,1210,5,1489.0
48434,104174,69677,14854,50230,19447,3714,38,-917.0
42813,111049,85126,20235,48842,36284,13365,661,-3345.0
44265,110632,82529,19188,49930,32599,10772,387,-3026.0
34142,56933,31363,5716,28430,2933,73,0,2856.0
46389,86400,52026,10212,42780,9246,840,3,1803.0
35908,104573,101267,32251,9028,92239,86517,26178,351.0
46216,108017,76754,17171,50482,26272,7053,170,-2218.0
33158,54907,30070,5453,27422,2648,63,0,2868.0
48259,94687,59300,12012,46528,12772,1631,11,860.0
45399,110230,80512,18407,50582,29930,9066,269,-2726.0
41102,71447,40764,7658,35580,5184,287,0,2761.0
48169,104251,70046,14988,50164,19882,3923,53,-1024.0
48481,104200,69764,14898,50140,19624,3920,47,-853.0
40634,110934,88827,21907,46212,42615,18510,1182,-3380.0
39648,110829,90616,22760,44672,45944,21485,1626,-3325.0
43788,110312,82856,19377,49450,33406,11412,428,-3045.0
41016,111133,88170,21562,46968,41202,17197,1066,-3509.0
35911,104582,101226,32172,9420,91806,85742,25725,383.0
43444,77442,45084,8612,38496,6588,450,0,2474.0
46611,108252,76597,17082,50702,25895,6848,161,-2126.0
44316,110142,81738,18918,49968,31770,10206,360,-3006.0
36681,108752,95969,25972,36106,59863,36540,4723,-2074.0
42564,75263,43530,8270,37440,6090,383,2,2561.0
35809,104795,100917,31354,13710,87207,77375,20945,577.0
41714,73099,41955,7917,36408,5547,283,0,2653.0
48363,100578,65728,13768,48848,16880,2882,25,-255.0
47594,106572,73475,16058,50602,22873,5368,114,-1561.0
47696,91539,56393,11274,45142,11251,1255,2,1276.0
39660,110699,90722,22861,44278,46444,22143,1738,-3178.0
46370,109255,78058,17533,50918,27140,7419,172,-2360.0
39138,110464,91210,23102,43808,47402,22848,1766,-3218.0
47540,107666,74781,16429,50988,23793,5690,100,-1774.0
41156,111275,88264,21580,47048,41216,17179,978,-3435.0
47466,106695,73651,16097,50720,22931,5255,96,-1675.0
46587,87012,52522,10332,43052,9470,908,5,1765.0
38367,110315,92867,23953,42016,50851,26283,2419,-3034.0
41842,111181,86841,20956,47946,38895,15289,804,-3454.0
44956,110243,81046,18622,50360,30686,9523,322,-2863.0
35953,107600,97548,27208,31848,65700,43904,6719,-1307.0
40864,110814,87993,21536,46770,41223,17274,1080,-3493.0
46856,87343,52641,10342,43230,9411,883,2,1812.0
48169,93105,57646,11569,45878,11768,1349,9,1141.0
36256,108273,96971,26665,33952,63019,40369,5726,-1711.0
48697,99443,64141,13299,48488,15653,2467,17,96.0
48834,100354,65045,13542,48838,16207,2678,30,-17.0
45523,110275,80322,18313,50766,29556,8743,243,-2743.0
48276,105095,70928,15233,50458,20470,4179,66,-1124.0
48084,104540,70552,15159,50150,20402,4240,60,-1063.0
28074,45529,24486,4370,22752,1734,25,0,2661.0
46807,87645,53028,10454,43332,9696,981,3,1736.0
47467,106269,73197,15977,50532,22665,5205,99,-1582.0
46703,109025,77392,17297,51002,26390,7021,155,-2227.0
41172,111051,87782,21398,47176,40606,16699,986,-3495.0
47939,105810,72123,15611,50580,21543,4650,77,-1359.0
36152,108004,97137,26858,33126,64011,41752,6172,-1573.0
35708,106858,98611,28179,28148,70463,50562,8996,-718.0
45902,109283,78711,17800,50622,28089,8039,220,-2470.0
22922,36423,19241,3380,18202,1039,19,0,2360.0
35571,105384,100220,30083,19942,80278,65500,14981,324.0
48674,100589,65427,13653,48936,16491,2717,20,-141.0
43199,110809,84170,19848,49252,34918,12305,523,-3288.0
46397,86068,51694,10130,42608,9086,852,3,1893.0
36147,108073,97201,26855,33272,63929,41529,6035,-1580.0
44352,80087,47087,9066,39778,7309,531,2,2286.0
37770,109810,93606,24428,40644,52962,28522,2850,-2862.0
18834,29575,15451,2686,14786,665,3,0,2024.0
30998,50821,27593,4966,25390,2203,41,0,2804.0
22318,35311,18576,3250,17652,924,7,0,2333.0
44382,110452,82175,19071,49924,32251,10604,390,-2966.0
47418,106778,73942,16216,50588,23354,5602,98,-1634.0
43308,110959,84439,19967,49076,35363,12807,590,-3179.0
38313,110206,92737,23890,42134,50603,25938,2271,-3046.0
25316,40466,21490,3793,20222,1268,22,0,2547.0
48339,95198,59806,12147,46730,13076,1738,9,800.0
43688,110907,83693,19641,49540,34153,11827,482,-3167.0
39432,110792,90910,22899,44426,46484,21940,1704,-3349.0
46548,108576,77045,17221,50764,26281,7048,192,-2204.0
38239,110190,93043,24067,41684,51359,26822,2505,-2975.0
35615,106116,99468,29089,24402,75066,57312,11457,-122.0
48288,95117,59743,12129,46712,13031,1693,6,785.0
44246,79593,46667,8966,39538,7129,517,0,2354.0
48041,105534,71731,15495,50492,21239,4550,63,-1257.0
37242,62929,35060,6453,31402,3658,125,0,2920.0
47520,104266,70789,15277,49916,20873,4434,72,-1234.0
46471,108563,77044,17210,50828,26216,6907,159,-2258.0
34974,58181,31995,5824,29046,2949,89,0,2964.0
37058,109265,95519,25590,37498,58021,34269,4116,-2278.0
45658,109469,79416,18081,50346,29070,8777,264,-2476.0
48635,100244,65087,13566,48778,16309,2688,33,-88.0
36493,108573,96126,26070,35832,60294,36909,4709,-2024.0
32562,53591,29201,5273,26764,2437,63,0,2899.0
29404,47888,25853,4630,23926,1927,36,0,2739.0
47227,106868,74176,16287,50630,23546,5608,101,-1752.0
36136,107910,97227,26935,32844,64383,42222,6256,-1482.0
48803,99233,63855,13222,48378,15477,2477,19,203.0
47971,92791,57507,11553,45696,11811,1399,7,1134.0
35623,105746,99973,29668,21938,78035,61870,13321,182.0
48392,102924,68409,14529,49644,18765,3636,52,-652.0
45410,110056,80250,18322,50568,29682,8920,278,-2718.0
47718,104229,70549,15190,49958,20591,4313,64,-1152.0
35727,105287,100514,30505,17998,82516,69291,16831,449.0
7046,10717,5433,918,5358,75,1,0,844.0
44515,109921,81395,18831,49804,31591,10313,395,-2842.0
38575,110277,92236,23649,42578,49658,25121,2227,-3115.0
40976,111326,88756,21812,46640,42116,18046,1148,-3406.0
45300,109349,79455,18090,50370,29085,8609,298,-2684.0
26140,41830,22236,3928,20904,1332,22,0,2618.0
47304,107324,74638,16413,50798,23840,5728,96,-1795.0
43946,110878,83313,19483,49728,33585,11422,422,-3102.0
44321,110663,82484,19164,49984,32500,10695,381,-3022.0
34242,57081,31446,5733,28494,2952,93,0,2874.0
39630,110903,90741,22797,44700,46041,21503,1588,-3329.0
47470,91276,56325,11278,44982,11343,1312,6,1241.0
48121,93695,58323,11754,46122,12201,1451,9,995.0
43001,76051,43995,8360,37830,6165,391,1,2585.0
47872,106793,73417,16006,50798,22619,5197,94,-1510.0
40368,111053,89501,22203,45784,43717,19485,1358,-3387.0
40101,110963,89703,22288,45678,44025,19607,1317,-3447.0
47473,107594,74730,16415,50970,23760,5654,115,-1806.0
39305,110820,91331,23094,44098,47233,22624,1763,-3278.0
18280,28592,14884,2579,14294,590,4,0,1993.0
46784,108385,76458,17001,50910,25548,6565,162,-2144.0
9768,14928,7602,1290,7464,138,0,0,1152.0
48583,101032,66032,13837,49042,16990,2948,49,-254.0
38290,110210,92834,23959,41914,50920,26382,2466,-3045.0
43903,110249,82524,19240,49608,32916,11033,419,-3062.0
47250,106940,74237,16301,50668,23569,5604,90,-1754.0
35642,105688,99984,29760,21408,78576,62872,13878,178.0
46344,107545,76021,16937,50420,25601,6705,158,-2117.0
43871,78878,46221,8875,39192,7029,494,1,2339.0
40664,111119,89170,22038,46112,43058,18895,1198,-3323.0
48633,98980,63704,13189,48274,15430,2432,23,168.0
35634,105392,100293,30205,19356,80937,66680,15618,330.0
48501,102295,67534,14261,49502,18032,3291,41,-521.0
43330,76897,44596,8490,38252,6344,393,0,2539.0
18680,29248,15240,2643,14622,618,4,0,2029.0
48355,104655,70374,15073,50310,20064,4035,43,-999.0
48493,101391,66533,13985,49156,17377,3079,37,-350.0
48328,96786,61558,12625,47366,14192,2054,12,475.0
42028,73226,41848,7871,36470,5378,286,0,2779.0
35647,105387,100285,30174,19526,80759,66335,15379,371.0
26348,42338,22586,4002,21160,1426,18,0,2594.0
48044,92785,57434,11527,45706,11728,1373,6,1166.0
42343,111026,85891,20569,48368,37523,14290,697,-3361.0
48674,98352,63030,13013,47982,15048,2388,14,339.0
40790,110873,88509,21785,46308,42201,18257,1200,-3359.0
48481,98797,63638,13182,48184,15454,2429,17,140.0
43809,110994,83702,19640,49564,34138,11866,491,-3123.0
43101,111106,84810,20087,49098,35712,12910,567,-3282.0
48385,95026,59589,12087,46656,12933,1714,7,861.0
48082,103315,69074,14725,49798,19276,3719,52,-884.0
42234,110803,85959,20658,47970,37989,14863,800,-3268.0
40432,70248,40054,7519,34994,5060,260,0,2719.0
43990,110407,82741,19320,49562,33179,11283,420,-2996.0
48216,94985,59621,12092,46690,12931,1605,6,760.0
47616,106544,73435,16046,50594,22841,5356,100,-1539.0
35811,104804,100990,31418,13472,87518,77860,21181,579.0
38502,110431,92740,23864,42296,50444,25839,2312,-3053.0
46319,109300,78142,17561,50918,27224,7464,201,-2400.0
36028,107473,97749,27408,31050,66699,45373,7186,-1104.0
46140,109010,78083,17582,50674,27409,7662,204,-2369.0
30260,49298,26620,4768,24632,1988,34,0,2814.0
39260,110810,91369,23122,44006,47363,22798,1860,-3303.0
37893,109809,93653,24475,40456,53197,28897,2913,-2738.0
46650,108095,76340,16998,50692,25648,6711,164,-2103.0
42652,111294,85828,20514,48572,37256,14150,736,-3328.0
43772,110457,82978,19404,49532,33446,11393,462,-3111.0
47632,92177,57190,11506,45344,11846,1489,10,1139.0
23926,38141,20201,3556,19066,1135,9,0,2430.0
47848,105726,72158,15639,50482,21676,4762,84,-1359.0
45771,84062,50106,9759,41658,8448,746,1,2056.0
35689,106826,98928,28433,27258,71670,52310,9715,-642.0
47754,105831,72417,15730,50454,21963,4923,80,-1390.0
43959,110411,82713,19303,49608,33105,11195,435,-3042.0
26190,42037,22405,3967,21008,1397,21,0,2591.0
48325,106047,72032,15553,50746,21286,4555,65,-1243.0
44339,79446,46422,8892,39492,6930,462,1,2423.0
48287,96757,61492,12594,47420,14072,1917,11,428.0
44643,79816,46583,8918,39658,6925,500,1,2492.0
36185,108012,97387,26992,32822,64565,42368,6227,-1432.0
47363,107775,75053,16519,50992,24061,5791,127,-1878.0
39970,69057,39184,7324,34424,4760,209,0,2773.0
46891,107990,75912,16837,50802,25110,6386,137,-2024.0
35900,104575,101246,32172,9460,91786,85655,25642,399.0
47445,105478,72357,15751,50208,22149,5062,91,-1427.0
42939,111033,84889,20126,49022,35867,12989,579,-3331.0
47531,89988,54877,10883,44456,10421,1076,1,1537.0
37471,109673,94251,24785,39792,54459,30089,3151,-2736.0
46851,107898,75794,16797,50806,24988,6286,145,-2050.0
48108,103104,68859,14675,49668,19191,3768,64,-812.0
46883,106156,73668,16167,50334,23334,5488,93,-1772.0
48767,97617,62056,12722,47780,14276,2057,19,484.0
48421,103777,69286,14757,50030,19256,3717,45,-827.0
38997,110604,91558,23231,43730,47828,23144,1827,-3280.0
48087,106252,72554,15733,50710,21844,4832,65,-1344.0
31072,50832,27550,4951,25394,2156,44,0,2839.0
39861,110893,90316,22605,45002,45314,20889,1501,-3321.0
44486,80029,46929,9018,39750,7179,529,0,2368.0
43859,110921,83510,19565,49630,33880,11661,463,-3117.0
47928,105374,71658,15485,50406,21252,4562,68,-1273.0
48906,97102,61338,12509,47622,13716,1858,18,633.0
35256,59052,32662,5975,29474,3188,104,0,2891.0
48011,105751,72024,15584,50544,21480,4663,67,-1300.0
23300,36856,19385,3391,18424,961,8,0,2438.0
47141,107342,74932,16541,50618,24314,6106,143,-1810.0
46939,107150,74909,16553,50500,24409,6150,149,-1855.0
37223,109387,94744,25140,38648,56096,32091,3695,-2560.0
44709,110343,81508,18804,50192,31316,9959,377,-2930.0
10490,16061,8194,1393,8030,164,1,0,1230.0
39847,110734,89919,22432,45246,44673,20242,1401,-3400.0
47992,101705,67428,14291,49110,18318,3485,34,-576.0
38904,110548,91833,23395,43296,48537,23956,2020,-3206.0
46525,108770,77337,17309,50820,26517,7130,139,-2217.0
44886,80917,47539,9151,40172,7367,573,0,2357.0
48581,100154,65076,13576,48696,16380,2762,31,-73.0
46619,86718,52186,10241,42926,9260,866,1,1846.0
47014,106961,74509,16406,50582,23927,5797,120,-1844.0
43004,110744,84548,20036,48880,35668,12984,580,-3228.0
46752,107412,75420,16720,50520,24900,6372,152,-1960.0
40906,111123,88571,21761,46576,41995,17971,1144,-3407.0
7660,11668,5923,1002,5834,89,0,0,913.0
47296,107748,75125,16553,50932,24193,5884,124,-1880.0
7676,11688,5931,1003,5844,87,0,0,916.0
6864,10428,5280,891,5214,66,0,0,825.0
41891,110910,86740,20991,47534,39206,15842,897,-3270.0
48456,104316,69939,14955,50148,19791,4020,60,-876.0
40923,110935,88141,21581,46796,41345,17343,1031,-3452.0
48660,99372,64074,13280,48468,15606,2436,28,82.0
48282,96272,61012,12475,47174,13838,1924,14,547.0
47074,107408,75058,16579,50642,24416,6124,142,-1855.0
48308,100863,66107,13881,48928,17179,3007,38,-329.0
39268,110789,91258,23059,44162,47096,22465,1750,-3322.0
39550,110813,90773,22842,44494,46279,21825,1720,-3332.0
34558,57561,31685,5772,28738,2947,85,0,2910.0
45321,82773,49136,9540,41032,8104,709,1,2144.0
48393,96424,61120,12505,47210,13910,2004,15,584.0
40110,111031,89731,22282,45770,43961,19491,1284,-3472.0
37893,109846,93522,24400,40644,52878,28558,2911,-2831.0
24568,39224,20804,3667,19606,1198,12,0,2481.0
48343,103988,69642,14874,50040,19602,3908,57,-877.0
40782,111016,88689,21832,46386,42303,18244,1150,-3377.0
47066,106365,73865,16239,50296,23569,5773,116,-1673.0
48100,92773,57400,11520,45680,11720,1413,6,1207.0
43734,110340,82932,19410,49404,33528,11532,498,-3084.0
43831,78250,45631,8732,38870,6761,510,1,2480.0
19926,31403,16460,2870,15700,760,3,0,2113.0
27568,44648,23986,4277,22310,1676,28,0,2629.0
44408,110161,81779,18948,49870,31909,10421,382,-2922.0
37220,109253,94563,25059,38772,55791,31709,3506,-2529.0
40102,110865,89796,22376,45336,44460,20193,1452,-3343.0
46993,107817,75558,16717,50814,24744,6189,145,-1983.0
42755,111441,85717,20419,48920,36797,13601,611,-3388.0
40625,111003,88828,21884,46352,42476,18299,1141,-3434.0
48533,101646,66780,14049,49266,17514,3114,31,-382.0
38830,66315,37296,6923,33054,4242,207,0,2888.0
47739,106792,73562,16062,50752,22810,5288,93,-1553.0
35677,106507,99132,28695,26094,73038,54319,10369,-393.0
36402,108492,96502,26326,35048,61454,38396,5182,-1914.0
48169,105622,71766,15506,50496,21270,4630,59,-1193.0
37259,109355,94479,25007,38916,55563,31523,3591,-2624.0
48621,99086,63814,13215,48338,15476,2410,15,134.0
44483,110092,81560,18863,49942,31618,10208,365,-2912.0
43059,111228,84997,20151,49088,35909,13052,617,-3323.0
42468,110418,85009,20288,48290,36719,13838,636,-3229.0
41588,111073,87242,21168,47476,39766,16121,934,-3411.0
42868,75860,43917,8352,37722,6195,416,0,2573.0
43025,110663,84451,20015,48812,35639,13039,617,-3202.0
47515,105565,72311,15713,50344,21967,4877,75,-1452.0
48347,97287,62093,12770,47566,14527,2155,15,383.0
47636,107219,74140,16234,50876,23264,5467,114,-1677.0
48531,100239,65237,13629,48700,16537,2839,31,-100.0
37926,109930,93484,24350,40868,52616,28194,2798,-2870.0
41722,111105,87071,21086,47626,39445,15853,892,-3398.0
38302,110300,92816,23906,42196,50620,25908,2282,-3088.0
35582,105738,99814,29564,22244,77570,61250,13150,94.0
33012,54730,30002,5445,27334,2668,62,0,2839.0
36192,108119,97370,26958,32992,64378,42135,6230,-1515.0
