N0,N1,N2,Volume,Enclosing_surface,Contact_surface,TETRAVOXEL,OCTOVOXEL,MISC_Async
42592,75256,43518,8269,37422,6096,412,0,2585.0
35910,107513,97847,27426,31138,66709,45237,7136,-1182.0
48813,102955,67970,14352,49828,18142,3299,33,-524.0
48017,94294,59072,11965,46354,12718,1586,3,830.0
22246,35055,18374,3204,17524,850,7,0,2361.0
9586,14685,7496,1275,7342,154,1,0,1122.0
35588,106083,99518,29145,24166,75352,57751,11666,-122.0
48202,105566,71652,15470,50484,21168,4598,82,-1182.0
42054,110799,86075,20688,48022,38053,14755,748,-3358.0
47345,106614,73822,16190,50504,23318,5606,115,-1637.0
38917,110386,91507,23262,43442,48065,23502,1923,-3224.0
41472,110995,87238,21166,47480,39758,16035,894,-3451.0
45606,83078,49195,9529,41216,7979,646,2,2194.0
48565,94878,59289,11997,46596,12693,1686,11,979.0
46902,105986,73432,16094,50300,23132,5386,94,-1746.0
48164,106185,72378,15673,50718,21660,4749,78,-1316.0
12102,18629,9553,1632,9314,239,1,0,1394.0
45106,110146,80937,18614,50190,30747,9766,350,-2717.0
46519,108671,77125,17230,50870,26255,6931,163,-2257.0
49025,101798,66529,13948,49370,17159,3058,39,-192.0
43409,110635,83791,19718,49274,34517,12087,441,-3153.0
48692,101158,66033,13817,49164,16869,2830,28,-250.0
45689,83923,49997,9729,41620,8377,683,1,2034.0
48671,100675,65550,13693,48942,16608,2791,23,-147.0
36046,107778,97664,27245,31858,65806,44062,6814,-1313.0
45790,109463,79037,17905,50644,28393,8175,228,-2541.0
45980,108516,77668,17477,50474,27194,7568,196,-2345.0
47041,106979,74435,16365,50680,23755,5619,97,-1868.0
40510,70701,40457,7617,35212,5245,277,0,2649.0
36145,108146,96955,26668,33902,63053,40342,5671,-1714.0
46096,84623,50397,9805,41964,8433,695,2,2065.0
24950,39657,20953,3681,19820,1133,17,0,2565.0
35588,105987,99696,29338,23364,76332,59259,12306,-41.0
47244,90165,55343,11036,44470,10873,1225,2,1386.0
44383,110340,81928,18975,50006,31922,10328,385,-3004.0
46230,108525,77286,17313,50694,26592,7137,180,-2322.0
46985,89300,54637,10867,44072,10565,1156,3,1455.0
35899,104601,101228,32121,9730,91498,85141,25359,405.0
46862,108007,75864,16803,50910,24954,6187,120,-2084.0
45554,109742,79723,18155,50516,29207,8710,278,-2620.0
38948,110435,91630,23327,43298,48332,23839,2018,-3184.0
47662,91986,56880,11402,45348,11532,1290,6,1154.0
45483,109889,79946,18220,50572,29374,8745,271,-2680.0
35844,104703,101088,31713,11898,89190,80907,22914,516.0
36671,108719,95781,25870,36342,59439,36035,4603,-2137.0
47381,89578,54607,10832,44222,10385,1134,3,1578.0
35601,105785,99903,29604,22182,77721,61421,13189,115.0
47296,107513,74865,16480,50850,24015,5813,110,-1832.0
41689,111137,87324,21208,47400,39924,16337,953,-3332.0
42842,111103,85218,20270,48816,36402,13471,652,-3313.0
36804,62062,34520,6345,30970,3550,122,0,2917.0
46986,107356,75075,16590,50610,24465,6136,146,-1885.0
35800,104943,100785,31066,15174,85611,74595,19474,576.0
36342,108411,96858,26578,34248,62610,39915,5672,-1789.0
48184,100745,66144,13913,48810,17334,3125,34,-330.0
42970,110780,84661,20085,48812,35849,13156,626,-3234.0
35654,106432,99087,28671,26148,72939,54136,10230,-362.0
44195,78954,46022,8797,39262,6760,430,1,2466.0
40959,111231,88640,21776,46624,42016,17983,1151,-3408.0
43645,110724,83603,19642,49354,34249,12016,527,-3118.0
41310,111104,87598,21301,47390,40208,16324,914,-3497.0
40378,111242,89709,22256,45882,43827,19478,1318,-3411.0
45442,109402,79362,18040,50484,28878,8434,234,-2638.0
48786,98225,62709,12898,48030,14679,2165,12,372.0
45390,82829,49143,9538,41058,8085,713,0,2166.0
48035,105352,71494,15420,50468,21026,4416,53,-1243.0
45354,109220,79306,18049,50318,28988,8584,254,-2609.0
40475,111120,89341,22113,46004,43337,19112,1305,-3417.0
44248,110467,82385,19155,49840,32545,10787,386,-2989.0
35807,104913,100835,31165,14680,86155,75553,19999,564.0
40399,110999,89356,22147,45830,43526,19339,1351,-3391.0
40846,71343,40862,7701,35518,5344,307,0,2664.0
47817,103301,69387,14853,49656,19731,3989,61,-950.0
47364,106193,73336,16055,50342,22994,5509,118,-1548.0
44153,79721,46870,9024,39596,7274,529,1,2278.0
43466,110771,83879,19745,49288,34591,12195,520,-3171.0
42186,111322,86396,20734,48388,38008,14546,746,-3474.0
48566,99424,64258,13347,48434,15824,2556,26,53.0
47664,105611,72170,15649,50446,21724,4719,70,-1426.0
48882,99042,63481,13092,48410,15071,2222,14,229.0
44141,109978,81786,18965,49782,32004,10414,391,-3016.0
42899,76006,44032,8377,37802,6230,402,1,2548.0
45488,109379,79319,18032,50446,28873,8487,250,-2604.0
42421,110902,85438,20374,48632,36806,13638,623,-3417.0
45058,81765,48244,9313,40610,7634,545,0,2224.0
36660,61802,34376,6320,30832,3544,138,0,2914.0
35595,105683,99950,29701,21694,78256,62295,13579,161.0
43962,110614,82936,19363,49694,33242,11226,426,-3079.0
35909,107514,97877,27448,31066,66811,45382,7195,-1176.0
47663,106150,72934,15900,50468,22466,5214,101,-1453.0
43315,110935,84389,19949,49084,35305,12767,591,-3180.0
47304,105757,72818,15893,50278,22540,5201,82,-1528.0
35838,107097,98366,27931,29146,69220,48805,8340,-824.0
29186,47505,25632,4588,23736,1896,33,0,2725.0
35704,106599,98884,28496,26792,72092,53015,9926,-507.0
35602,105989,99619,29270,23618,76001,58753,12060,-38.0
16722,26045,13504,2331,13022,482,1,0,1850.0
35865,104700,101081,31742,11710,89371,81280,23147,504.0
43029,77059,45028,8628,38288,6740,483,1,2370.0
40079,111039,90044,22457,45346,44698,20347,1479,-3373.0
37449,109785,94500,24895,39630,54870,30525,3281,-2731.0
47991,105814,72164,15636,50512,21652,4790,69,-1295.0
46443,86969,52607,10367,43012,9595,945,3,1714.0
35664,105696,100042,29798,21296,78746,63104,13944,212.0
48768,99008,63650,13173,48262,15388,2484,32,237.0
42424,110949,85733,20523,48328,37405,14293,726,-3315.0
43794,110553,83167,19481,49448,33719,11657,492,-3073.0
35599,105708,100050,29773,21462,78588,62784,13801,168.0
44588,110353,81663,18859,50172,31491,10009,338,-2961.0
36553,108589,96136,26090,35732,60404,37125,4801,-1990.0
47171,106927,74419,16391,50492,23927,5943,135,-1728.0
48491,96030,60589,12350,47078,13511,1874,13,700.0
47546,106883,73879,16176,50702,23177,5479,112,-1634.0
42283,111255,86355,20743,48252,38103,14751,751,-3360.0
35893,107453,97961,27528,30754,67207,45945,7393,-1127.0
46772,107615,75567,16744,50670,24897,6275,142,-2020.0
38860,110594,92282,23631,42778,49504,25038,2248,-3083.0
41002,71257,40636,7629,35498,5138,261,0,2752.0
37290,63253,35358,6527,31554,3804,145,0,2868.0
40547,111297,89417,22109,46180,43237,18937,1251,-3442.0
35662,106240,99467,29053,24616,74851,57008,11374,-164.0
43232,77042,44839,8563,38300,6539,442,0,2466.0
41985,73639,42307,7992,36662,5645,315,1,2661.0
46470,108948,77578,17385,50846,26732,7256,194,-2285.0
44465,79875,46771,8975,39692,7079,491,1,2386.0
41854,73225,42003,7927,36444,5559,337,0,2705.0
48675,98548,63192,13046,48108,15084,2332,21,273.0
41104,71876,41198,7768,35788,5410,300,0,2658.0
35712,106719,98891,28450,27082,71809,52555,9762,-566.0
40393,111313,89858,22320,45796,44062,19721,1361,-3382.0
42992,111305,85172,20207,49102,36070,13101,586,-3348.0
47386,105447,72322,15732,50252,22070,4943,76,-1471.0
41759,110874,86848,21031,47510,39338,15854,845,-3298.0
34632,57800,31872,5815,28854,3018,92,0,2889.0
48916,101276,65998,13799,49202,16796,2872,36,-161.0
10444,15972,8139,1382,7986,153,0,0,1229.0
44459,110187,81586,18847,50090,31496,10007,347,-2989.0
45398,109766,79980,18261,50394,29586,8978,302,-2649.0
41124,111155,88228,21600,46856,41372,17443,1074,-3403.0
42294,110854,85989,20663,48000,37989,14854,762,-3234.0
37142,109311,94881,25205,38532,56349,32247,3596,-2493.0
45414,83519,49816,9705,41402,8414,715,0,2006.0
35817,104730,101037,31591,12528,88509,79674,22223,533.0
40649,111074,88921,21916,46346,42575,18382,1143,-3420.0
35933,104566,101285,32360,8410,92875,87746,26939,292.0
48406,104458,70195,15043,50132,20063,4194,74,-900.0
20856,32924,17286,3019,16458,828,8,0,2199.0
36621,108840,96040,25966,36284,59756,36272,4627,-2145.0
39548,110807,90572,22716,44848,45724,21111,1506,-3403.0
40626,70615,40273,7561,35180,5093,255,0,2723.0
37049,109230,95343,25502,37674,57669,33882,4055,-2340.0
49001,101086,65719,13717,49136,16583,2814,31,-83.0
48041,105528,71778,15522,50424,21354,4680,79,-1231.0
48371,93812,58267,11728,46166,12101,1480,9,1098.0
41355,111206,87882,21433,47166,40716,16874,993,-3402.0
48392,96030,60647,12366,47098,13549,1834,8,643.0
45894,108757,78060,17606,50484,27576,7789,228,-2409.0
39396,67792,38345,7149,33796,4549,200,0,2800.0
48029,104636,70773,15239,50112,20661,4412,63,-1073.0
36101,107942,97528,27078,32588,64940,42766,6295,-1391.0
48083,104187,70128,15034,50052,20076,4083,51,-1010.0
32722,54147,29641,5374,27038,2603,71,0,2842.0
42145,111257,86522,20811,48178,38344,14901,769,-3401.0
37066,109213,95215,25421,37904,57311,33405,3868,-2353.0
47311,107854,75266,16598,50944,24322,5966,117,-1875.0
41456,72394,41445,7806,36054,5391,286,0,2701.0
43616,110522,83186,19477,49510,33676,11502,500,-3197.0
25314,40375,21399,3770,20178,1221,19,0,2568.0
44695,110030,81146,18693,50134,31012,9762,325,-2882.0
37008,109278,95243,25394,38122,57121,33034,3728,-2421.0
42571,111265,85871,20523,48604,37267,14057,659,-3346.0
42010,110970,86411,20815,47932,38479,15106,806,-3364.0
44783,110064,81023,18635,50236,30787,9592,333,-2893.0
48099,94106,58822,11898,46256,12566,1594,9,917.0
24060,38314,20276,3567,19150,1126,14,0,2455.0
37396,109462,94608,25060,38856,55752,31750,3576,-2518.0
48622,97662,62263,12795,47756,14507,2150,10,428.0
48728,101490,66455,13951,49204,17251,3082,40,-258.0
47343,106496,73561,16086,50606,22955,5284,93,-1678.0
48090,103663,69531,14868,49854,19677,3955,56,-910.0
37232,109500,94638,25037,39054,55584,31392,3512,-2667.0
44418,110869,82672,19226,49988,32684,10893,440,-3005.0
35799,107417,98133,27626,30510,67623,46397,7511,-1111.0
36544,108530,96372,26271,35118,61254,38294,5196,-1885.0
47938,103391,69386,14844,49708,19678,3975,52,-911.0
38670,110554,92543,23746,42610,49933,25334,2234,-3087.0
47958,106213,72651,15779,50628,22023,4957,96,-1383.0
42240,111281,86329,20715,48368,37961,14545,726,-3427.0
47749,106290,72960,15889,50586,22374,5118,103,-1470.0
37053,109072,95175,25460,37590,57585,33892,4071,-2304.0
44892,110043,80843,18558,50338,30505,9367,286,-2866.0
42409,75219,43613,8303,37408,6205,403,1,2500.0
28166,45465,24351,4330,22722,1629,21,0,2722.0
48335,98772,63732,13218,48156,15576,2460,25,77.0
43264,77354,45125,8632,38458,6667,438,0,2403.0
45884,108607,77848,17531,50510,27338,7587,186,-2406.0
48145,100908,66320,13955,48910,17410,3088,31,-398.0
39664,110931,90676,22765,44762,45914,21407,1614,-3356.0
40090,110854,89991,22471,45156,44835,20542,1422,-3244.0
45294,109842,80170,18324,50396,29774,9050,302,-2702.0
42808,110892,84833,20112,48994,35839,12904,540,-3363.0
46240,109381,78348,17634,50892,27456,7597,202,-2427.0
36898,62319,34717,6391,31088,3629,143,0,2905.0
37902,109742,93230,24258,40912,52318,27918,2726,-2868.0
46783,108437,76648,17084,50792,25856,6853,171,-2090.0
38427,110267,92609,23826,42262,50347,25743,2279,-3057.0
46836,108802,76989,17169,50964,26025,6874,164,-2146.0
47223,89403,54542,10824,44140,10402,1123,7,1538.0
38784,66474,37485,6972,33138,4347,198,0,2823.0
48269,94110,58668,11841,46290,12378,1530,7,986.0
46995,107417,75174,16625,50598,24576,6221,143,-1873.0
47103,108323,76081,16864,50978,25103,6367,131,-2003.0
44178,79139,46247,8861,39328,6919,483,0,2425.0
48808,97839,62280,12783,47862,14418,2115,14,466.0
29190,47351,25478,4550,23656,1822,39,0,2767.0
46771,107559,75536,16740,50632,24904,6295,123,-1992.0
48212,94390,59024,11942,46396,12628,1598,8,904.0
48208,101000,66348,13954,48972,17376,3056,32,-398.0
48217,103160,68842,14664,49700,19142,3760,47,-765.0
42524,111153,85753,20488,48578,37175,13997,674,-3364.0
47714,104572,70967,15315,50044,20923,4484,82,-1206.0
11652,17920,9181,1567,8960,221,0,0,1346.0
19026,29907,15639,2721,14952,687,3,0,2037.0
26854,43131,23000,4074,21556,1444,19,0,2649.0
47249,89805,54925,10918,44342,10583,1121,5,1451.0
48562,100455,65441,13680,48802,16639,2851,24,-132.0
47619,106085,72908,15899,50422,22486,5241,111,-1457.0
44595,110009,81363,18803,49908,31455,10193,395,-2854.0
43148,110836,84286,19895,49202,35084,12432,540,-3297.0
45553,110076,80225,18327,50488,29737,9100,315,-2625.0
36007,107770,97530,27140,32220,65310,43330,6533,-1373.0
40496,70004,39744,7433,34890,4854,224,0,2803.0
36590,108891,95932,25867,36662,59270,35567,4400,-2236.0
46184,109105,78028,17533,50858,27170,7389,178,-2426.0
48626,96389,60874,12420,47228,13646,1933,16,691.0
39726,110914,90344,22598,45100,45244,20714,1510,-3442.0
43511,110761,83798,19716,49300,34498,12161,547,-3168.0
47196,89389,54545,10825,44140,10405,1109,2,1527.0
45581,108878,78462,17737,50502,27960,7874,223,-2572.0
44329,110703,82598,19215,49906,32692,10891,405,-2991.0
46974,107311,75047,16582,50602,24445,6107,116,-1872.0
35640,105797,100032,29700,21864,78168,62069,13426,175.0
47047,107146,74716,16468,50624,24092,5898,125,-1851.0
44401,111045,82823,19247,50164,32659,10717,373,-3068.0
11688,17948,9182,1565,8974,208,0,0,1357.0
40730,70817,40382,7578,35296,5086,225,0,2717.0
24290,38741,20534,3618,19360,1174,21,0,2465.0
37851,109815,93251,24236,41086,52165,27643,2663,-2949.0
48549,100396,65307,13626,48858,16449,2680,23,-166.0
45812,108972,78318,17671,50610,27708,7752,228,-2513.0
47129,108528,76341,16947,51000,25341,6528,139,-2005.0
42265,110773,85539,20442,48426,37113,13921,661,-3411.0
35774,104956,100806,31065,15222,85584,74512,19434,559.0
48936,102319,67171,14127,49580,17591,3159,34,-339.0
47246,106480,73759,16178,50450,23309,5580,102,-1653.0
48694,102210,67248,14163,49518,17730,3174,38,-431.0
35911,107493,97759,27366,31322,66437,44849,6967,-1189.0
48,72,36,6,36,0,0,0,6.0
40738,110984,88677,21836,46338,42339,18308,1210,-3405.0
39624,110784,90635,22777,44608,46027,21568,1620,-3302.0
38335,110313,92930,23985,41950,50980,26413,2451,-3033.0
37482,63665,35618,6578,31768,3850,129,0,2857.0
48382,95439,60031,12205,46832,13199,1775,12,769.0
45639,109555,79277,17985,50644,28633,8267,243,-2624.0
47827,106372,73023,15909,50592,22431,5188,97,-1431.0
35935,104546,101357,32631,6928,94429,90690,28777,115.0
40555,111041,89208,22066,46020,43188,19001,1223,-3344.0
47078,107861,75543,16709,50832,24711,6197,144,-1949.0
47786,106082,72654,15790,50568,22086,4946,82,-1432.0
31138,51249,27924,5042,25596,2328,57,0,2771.0
46563,107774,76040,16918,50572,25468,6630,169,-2089.0
46681,108112,76247,16947,50812,25435,6488,131,-2131.0
39618,67999,38385,7145,33900,4485,199,0,2859.0
30678,50309,27325,4920,25130,2195,49,0,2774.0
47887,92558,57385,11540,45530,11855,1498,9,1174.0
35802,107121,98220,27811,29574,68646,47973,8048,-910.0
36116,60758,33750,6200,30300,3450,158,0,2908.0
42588,110823,85111,20258,48674,36437,13475,678,-3382.0
37974,64881,36473,6763,32368,4105,145,0,2803.0
46447,108635,77295,17318,50682,26613,7271,187,-2211.0
40556,111236,89466,22162,45960,43506,19316,1348,-3376.0
40522,70167,39903,7475,34956,4947,255,0,2783.0
38307,110300,93129,24103,41640,51489,27020,2601,-2967.0
48674,101931,66949,14080,49418,17531,3095,32,-388.0
35695,59918,33215,6090,29890,3325,138,1,2902.0
35686,106711,98908,28429,27242,71666,52227,9536,-546.0
32828,54064,29477,5326,26998,2479,68,0,2915.0
45758,109191,78772,17836,50528,28244,8135,224,-2497.0
33354,55175,30187,5469,27560,2627,55,0,2897.0
39659,110646,90198,22586,44880,45318,20886,1529,-3375.0
28818,46769,25170,4495,23370,1800,29,0,2724.0
37117,109213,95259,25451,37812,57447,33589,3881,-2288.0
35927,104561,101311,32436,8006,93305,88549,27439,241.0
38249,110285,93244,24157,41546,51698,27193,2601,-2949.0
45467,109851,79849,18174,50654,29195,8543,231,-2709.0
47511,107174,74212,16263,50846,23366,5482,93,-1714.0
44528,110500,81909,18938,50190,31719,10120,340,-3001.0
37893,109964,93592,24396,40808,52784,28348,2835,-2875.0
45483,82764,48957,9473,41076,7881,612,1,2203.0
45394,109269,79333,18056,50330,29003,8609,260,-2598.0
42530,110661,85179,20324,48414,36765,13833,668,-3276.0
41337,111139,87794,21409,47134,40660,16871,1037,-3417.0
40967,71344,40756,7663,35534,5222,276,1,2716.0
47752,105829,72487,15768,50366,22121,5097,102,-1358.0
24866,39813,21172,3741,19898,1274,17,0,2484.0
35585,105864,99686,29391,23026,76660,59812,12527,16.0
36276,108258,96704,26506,34372,62332,39514,5472,-1784.0
11120,17060,8720,1485,8530,190,0,0,1295.0
44468,110266,81745,18909,50036,31709,10194,356,-2962.0
48613,98817,63527,13139,48220,15307,2377,25,184.0
43864,77764,45088,8586,38660,6428,444,0,2602.0
47931,105742,72093,15611,50520,21573,4702,69,-1329.0
45060,110513,81280,18685,50450,30830,9613,326,-2858.0
36081,107957,97441,27045,32612,64829,42733,6429,-1480.0
42718,110687,84951,20226,48546,36405,13595,660,-3244.0
26248,41948,22268,3928,20968,1300,12,0,2640.0
47677,90935,55798,11126,44840,10958,1255,9,1414.0
43162,110833,84416,19957,49090,35326,12653,496,-3212.0
35921,104568,101284,32377,8306,92978,87956,27095,260.0
15040,23338,12059,2075,11668,391,2,0,1686.0
36338,108238,96777,26564,34170,62607,39898,5542,-1687.0
45288,110051,80444,18405,50458,29986,9135,278,-2724.0
48358,102022,67356,14221,49386,17970,3250,30,-529.0
39314,110620,91069,23016,44042,47027,22536,1778,-3253.0
47619,107179,74150,16246,50824,23326,5531,107,-1656.0
45710,109303,78836,17833,50674,28162,7955,216,-2590.0
48804,98814,63310,13054,48296,15014,2222,16,246.0
35612,106375,99247,28800,25694,73553,54987,10550,-316.0
43850,110204,82612,19294,49460,33152,11284,462,-3036.0
48010,103213,69111,14761,49656,19455,3901,60,-853.0
34428,57382,31596,5756,28656,2940,70,0,2886.0
35610,105254,100341,30313,18804,81537,67646,16038,384.0
40332,111033,89629,22262,45686,43943,19661,1314,-3334.0
35994,107724,97518,27158,32088,65430,43548,6646,-1370.0
45331,110232,80599,18444,50534,30065,9164,289,-2746.0
43873,110788,83301,19497,49620,33681,11548,475,-3111.0
44753,109919,80848,18578,50228,30620,9463,317,-2896.0
47758,105021,71451,15451,50196,21255,4629,88,-1263.0
31898,52311,28421,5120,26122,2299,67,0,2888.0
48007,105301,71479,15425,50408,21071,4485,79,-1240.0
42828,110569,84648,20116,48600,36048,13369,646,-3209.0
46021,108918,78093,17595,50616,27477,7686,203,-2399.0
32110,52657,28605,5152,26298,2307,61,0,2906.0
36147,107992,96963,26740,33486,63477,41020,5905,-1622.0
45404,109007,78940,17928,50312,28628,8383,274,-2591.0
42994,110510,84210,19921,48894,35316,12722,554,-3227.0
37441,109479,94183,24809,39512,54671,30455,3257,-2664.0
44034,79562,46830,9029,39486,7344,590,2,2273.0
46495,108707,77322,17322,50712,26610,7283,207,-2212.0
40602,111097,89121,22015,46152,42969,18793,1228,-3389.0
35674,105329,100399,30328,18830,81569,67669,16012,416.0
47345,106028,73130,15988,50332,22798,5364,95,-1541.0
38014,109903,93205,24217,41108,52097,27687,2708,-2901.0
41953,111158,86577,20837,48132,38445,14894,751,-3465.0
37940,64422,36054,6664,32124,3930,174,0,2908.0
48422,97163,61870,12699,47546,14324,2071,16,430.0
40894,111275,88779,21822,46626,42153,18023,1116,-3424.0
35777,107229,98367,27843,29676,68691,47877,7957,-928.0
42431,75258,43629,8304,37434,6195,390,1,2498.0
33244,55134,30246,5495,27522,2724,90,0,2861.0
47474,106227,73113,15945,50556,22557,5115,88,-1585.0
45650,109308,79102,17964,50420,28682,8468,270,-2520.0
48079,102921,68719,14644,49574,19145,3773,39,-767.0
35660,59854,33168,6078,29868,3300,118,0,2896.0
35834,107186,98293,27849,29492,68801,48202,8158,-908.0
38010,110022,93324,24242,41196,52128,27630,2674,-2930.0
47386,90615,55685,11112,44698,10987,1219,0,1344.0
40194,110840,89498,22230,45616,43882,19608,1334,-3378.0
42103,111388,86860,20944,48056,38804,15276,785,-3369.0
37841,109905,93933,24597,40284,53649,29337,3013,-2728.0
35224,58738,32365,5901,29324,3041,90,0,2950.0
45575,109464,79442,18088,50356,29086,8752,289,-2535.0
46468,108427,76893,17167,50784,26109,6859,150,-2233.0
38109,110288,93402,24217,41502,51900,27284,2595,-2994.0
48569,103667,69068,14694,49972,19096,3723,45,-724.0
48493,98030,62738,12925,47926,14812,2178,15,276.0
46540,107440,75662,16806,50488,25174,6464,140,-2044.0
47626,106581,73464,16052,50616,22848,5349,96,-1543.0
48524,101628,66793,14059,49232,17561,3164,32,-370.0
45742,108779,78280,17690,50420,27860,7939,216,-2447.0
39434,67393,37902,7032,33612,4290,169,0,2911.0
15520,24058,12419,2135,12028,391,2,0,1746.0
38170,65039,36493,6758,32438,4055,163,0,2866.0
39136,110390,91213,23137,43604,47609,23182,1888,-3178.0
41977,110996,86563,20883,47828,38735,15340,827,-3339.0
47943,104317,70420,15131,50054,20366,4209,59,-1085.0
36280,61088,33936,6231,30486,3450,116,0,2897.0
48485,98648,63518,13160,48076,15442,2496,19,195.0
45062,108786,79021,17980,50162,28859,8462,266,-2683.0
5724,8684,4391,740,4342,49,0,0,691.0
46593,107567,75757,16831,50528,25229,6511,161,-2048.0
47034,107870,75670,16767,50738,24932,6394,162,-1933.0
32726,54071,29560,5353,27002,2558,67,0,2862.0
46650,107819,76101,16949,50508,25593,6803,176,-2017.0
41954,73361,42056,7932,36520,5536,321,0,2717.0
45840,108971,78405,17717,50508,27897,7955,218,-2443.0
35905,107604,97726,27319,31538,66188,44528,6951,-1292.0
47177,106662,74012,16251,50518,23494,5626,107,-1724.0
31854,52365,28497,5139,26160,2337,45,0,2847.0
48151,93819,58483,11807,46124,12359,1571,11,1008.0
47116,106971,74478,16400,50556,23922,5859,114,-1777.0
37432,109589,94632,25040,39024,55608,31541,3538,-2565.0
43080,76959,44891,8591,38236,6655,487,2,2421.0
43453,77269,44917,8573,38396,6521,477,1,2528.0
48368,97732,62567,12898,47746,14821,2240,12,305.0
46054,109253,78577,17761,50588,27989,8077,232,-2383.0
10796,16554,8458,1440,8276,182,2,0,1260.0
48209,98322,63340,13118,47972,15368,2378,19,109.0
35768,104818,100915,31309,13976,86939,76866,20680,556.0
39043,110820,92003,23422,43474,48529,23872,1961,-3196.0
47468,90025,54995,10925,44440,10555,1145,2,1513.0
47055,89811,55110,10985,44310,10800,1191,7,1369.0
41214,111302,88222,21562,47072,41150,17158,998,-3428.0
42219,111379,86689,20880,48098,38591,15183,823,-3351.0
42512,74880,43178,8183,37258,5920,364,0,2627.0
36204,108155,97342,26940,33044,64298,42067,6258,-1549.0
46656,87168,52635,10358,43122,9513,924,4,1765.0
48432,103465,68968,14677,49874,19094,3717,42,-742.0
41403,110958,87541,21328,47114,40427,16730,973,-3342.0
12124,18660,9567,1634,9330,237,0,0,1397.0
37106,109423,95013,25233,38628,56385,32167,3552,-2537.0
38381,110270,92832,23945,41994,50838,26282,2391,-3002.0
48502,104017,69533,14833,50068,19465,3881,64,-815.0
35935,104544,101353,32689,6572,94781,91400,29253,55.0
48659,99864,64669,13454,48614,16055,2636,25,10.0
45414,82708,48966,9483,41034,7932,640,2,2189.0
46804,107544,75487,16725,50624,24863,6296,136,-1978.0
35726,106967,98550,28082,28608,69942,49751,8664,-773.0
36803,108889,95813,25854,36502,59311,35885,4555,-2127.0
42138,111089,86401,20791,48056,38345,14977,764,-3341.0
43786,110771,83424,19555,49518,33906,11735,500,-3116.0
35677,105294,100453,30389,18572,81881,68150,16211,447.0
47055,88413,53644,10601,43682,9962,1049,3,1685.0
35958,107630,97705,27299,31616,66089,44398,6874,-1266.0
48601,96502,61023,12463,47268,13755,1966,15,659.0
35742,104990,100720,30942,15788,84932,73414,18894,530.0
47600,106772,73639,16090,50738,22901,5296,108,-1623.0
39534,68117,38581,7203,33944,4637,229,0,2795.0
37508,109557,94349,24882,39406,54943,30745,3266,-2582.0
47833,92802,57673,11616,45650,12023,1502,7,1088.0
43910,110635,82953,19362,49734,33219,11167,444,-3134.0
35709,106402,99078,28705,25926,73152,54550,10423,-320.0
47381,107070,74283,16309,50712,23571,5646,99,-1715.0
46904,107146,74853,16517,50604,24249,5938,112,-1906.0
48711,101456,66415,13937,49208,17207,3040,37,-267.0
43206,76829,44619,8503,38220,6399,389,0,2493.0
42685,111183,85573,20404,48722,36851,13739,621,-3329.0
48503,100918,66006,13840,48972,17034,2974,29,-249.0
45985,109095,78328,17662,50684,27644,7727,189,-2444.0
40432,70066,39865,7470,34910,4955,246,0,2761.0
46632,108523,76886,17163,50794,26092,6935,174,-2168.0
48444,99165,64050,13291,48354,15696,2457,14,38.0
29782,48451,26130,4675,24210,1920,31,0,2786.0
45960,84292,50176,9760,41792,8384,708,0,2084.0
35924,104588,101248,32249,9002,92246,86584,26252,335.0
40161,111022,89780,22318,45652,44128,19718,1307,-3399.0
48474,97492,62202,12790,47664,14538,2164,22,394.0
35809,107145,98610,28050,28920,69690,49305,8441,-776.0
16926,26401,13709,2370,13198,511,5,0,1864.0
47727,106961,73744,16111,50822,22922,5317,107,-1601.0
43298,110762,83976,19771,49326,34650,12110,490,-3259.0
43673,110661,83249,19472,49666,33583,11329,429,-3211.0
40534,111314,89458,22117,46214,43244,18886,1198,-3439.0
44831,110388,81475,18790,50210,31265,9968,365,-2872.0
48145,99400,64618,13480,48356,16262,2688,23,-117.0
41664,110905,86854,21015,47618,39236,15669,850,-3402.0
30090,49115,26575,4770,24530,2045,55,0,2780.0
39606,68577,38979,7296,34182,4797,213,0,2712.0
43635,110803,83752,19700,49304,34448,12195,563,-3116.0
35743,104882,100832,31151,14758,86074,75366,19901,542.0
48639,101141,66079,13838,49130,16949,2881,31,-261.0
35922,104564,101314,32453,7910,93404,88744,27574,219.0
35815,104795,100908,31324,13872,87036,77051,20735,604.0
39264,110702,91592,23284,43480,48112,23742,2044,-3130.0
35641,106286,99266,28867,25330,73936,55626,10803,-246.0
43929,110668,82936,19345,49802,33134,11064,423,-3148.0
41581,111147,87552,21313,47226,40326,16695,1009,-3327.0
46369,86832,52532,10355,42934,9598,964,7,1714.0
43581,110851,83794,19693,49430,34364,11991,489,-3169.0
47520,106067,72931,15902,50450,22481,5167,106,-1518.0
43795,110385,82843,19353,49568,33275,11249,427,-3100.0
48490,100620,65652,13736,48888,16764,2844,30,-214.0
5588,8464,4273,719,4232,41,0,0,678.0
35800,104756,100991,31512,12910,88081,78936,21844,523.0
36990,109195,95273,25452,37834,57439,33527,3924,-2384.0
43927,78552,45846,8776,39036,6810,480,1,2445.0
42477,110739,85240,20329,48506,36734,13727,673,-3351.0
34662,57799,31842,5804,28860,2982,79,0,2901.0
46744,108819,77047,17182,51002,26045,6815,162,-2210.0
48604,102233,67329,14187,49536,17793,3161,42,-487.0
42659,110936,85371,20363,48564,36807,13808,633,-3269.0
35736,107218,98318,27798,29848,68470,47522,7812,-962.0
45908,108780,78089,17617,50476,27613,7828,232,-2400.0
46206,108808,77761,17479,50648,27113,7512,198,-2320.0
32234,52941,28796,5192,26440,2356,61,0,2897.0
47027,107461,75178,16620,50636,24542,6189,143,-1876.0
48169,93264,57866,11639,45898,11968,1468,7,1132.0
37674,109926,94112,24667,40222,53890,29482,3066,-2807.0
46144,109039,78033,17550,50766,27267,7507,202,-2412.0
36346,61213,34010,6245,30550,3460,113,0,2898.0
35008,58186,31981,5820,29042,2939,102,0,2983.0
18944,29652,15446,2678,14824,622,4,0,2060.0
48040,100422,65921,13864,48658,17263,3106,32,-325.0
47538,106711,73706,16130,50632,23074,5447,100,-1597.0
42850,76295,44387,8476,37918,6469,459,0,2466.0
40131,110815,89526,22243,45594,43932,19627,1339,-3401.0
48285,105713,71703,15467,50604,21099,4505,65,-1192.0
39297,110665,91182,23055,44034,47148,22597,1745,-3241.0
43187,111015,84627,20034,49050,35577,12915,607,-3235.0
43660,110571,83216,19484,49528,33688,11515,490,-3179.0
46558,86603,52130,10234,42856,9274,891,0,1851.0
40769,111062,88573,21758,46598,41975,17866,1127,-3478.0
36143,108039,97394,27007,32746,64648,42547,6415,-1509.0
47869,104828,71115,15343,50172,20943,4484,71,-1187.0
32926,54509,29851,5414,27218,2633,73,0,2854.0
24838,39613,20993,3698,19798,1195,17,0,2520.0
48667,97895,62460,12842,47868,14592,2159,19,390.0
37362,109337,94400,24972,38968,55432,31401,3488,-2547.0
35652,106374,99132,28745,25794,73338,54786,10528,-335.0
19636,30786,16060,2788,15392,668,2,0,2122.0
7480,11428,5818,987,5714,104,0,0,883.0
35745,105148,100462,30548,17636,82826,69876,17087,511.0
48012,102606,68431,14573,49424,19007,3758,60,-736.0
39739,110970,90735,22801,44664,46071,21642,1669,-3297.0
46040,108765,77827,17500,50654,27173,7457,182,-2398.0
44163,110758,82865,19317,49828,33037,11102,429,-3047.0
46889,108667,76821,17127,50880,25941,6907,177,-2084.0
47793,105505,71925,15568,50442,21483,4621,61,-1355.0
35562,59361,32738,5974,29632,3106,97,0,2965.0
36757,109013,95896,25831,36806,59090,35401,4333,-2191.0
35705,105003,100758,30910,16056,84702,72891,18549,550.0
48735,98636,63201,13035,48192,15009,2252,13,265.0
35618,106199,99296,28924,25048,74248,56103,10988,-209.0
37702,109780,93779,24508,40510,53269,28760,2806,-2807.0
35823,104865,100807,31170,14594,86213,75677,20039,595.0
45451,110042,80122,18267,50642,29480,8758,281,-2736.0
48409,100311,65404,13680,48728,16676,2855,37,-178.0
46062,108904,78063,17587,50604,27459,7696,190,-2366.0
38132,64776,36257,6701,32308,3949,160,0,2912.0
47033,107779,75549,16727,50736,24813,6307,145,-1924.0
47278,89916,55032,10947,44382,10650,1152,2,1447.0
48419,101498,66727,14045,49184,17543,3130,29,-397.0
47355,89719,54801,10891,44256,10545,1207,7,1546.0
32476,53624,29297,5302,26782,2515,60,0,2847.0
45561,83921,50110,9770,41600,8510,721,1,1980.0
48301,103396,69068,14729,49762,19306,3872,51,-756.0
40760,111480,89170,21943,46682,42488,18116,1064,-3493.0
44323,109749,81299,18797,49816,31483,10117,355,-2924.0
48041,104578,70571,15153,50224,20347,4130,55,-1119.0
42870,110876,84835,20130,48890,35945,13096,582,-3301.0
42360,110913,85750,20529,48326,37424,14261,698,-3332.0
38329,110186,93024,24075,41598,51426,26990,2547,-2908.0
47217,106705,73951,16213,50624,23327,5457,93,-1750.0
40785,111007,88669,21836,46322,42347,18363,1241,-3389.0
37218,109278,94970,25286,38224,56746,32830,3746,-2376.0
45727,84624,50724,9922,41916,8808,792,1,1905.0
44996,81827,48380,9358,40612,7768,603,2,2191.0
48782,101305,66133,13841,49220,16913,2865,24,-231.0
27318,43947,23468,4162,21964,1504,19,0,2677.0
45062,82038,48551,9399,40708,7843,622,2,2176.0
48461,98299,63151,13061,47936,15215,2427,21,252.0
48461,101666,66880,14086,49244,17636,3178,39,-411.0
43647,111198,84137,19791,49528,34609,12142,529,-3205.0
44893,110453,81460,18769,50306,31154,9841,325,-2869.0
7528,11396,5750,967,5698,52,0,0,915.0
41352,111305,87933,21421,47340,40593,16625,894,-3441.0
43855,110249,82699,19326,49442,33257,11365,455,-3021.0
46176,108877,77848,17501,50690,27158,7497,194,-2354.0
44215,110421,82215,19077,49968,32247,10485,383,-3068.0
35823,107168,98279,27847,29476,68803,48216,8173,-913.0
36972,62574,34908,6432,31224,3684,126,0,2874.0
48282,103399,69039,14710,49818,19221,3763,40,-788.0
41303,111398,88185,21529,47196,40989,17006,985,-3439.0
38656,110403,92366,23680,42652,49714,25099,2126,-3061.0
46310,85616,51306,10038,42384,8922,848,2,1962.0
45436,83180,49457,9613,41236,8221,708,0,2100.0
48360,98354,63220,13069,48026,15194,2302,20,157.0
39606,110654,90311,22635,44812,45499,21030,1538,-3372.0
19950,31377,16419,2859,15684,735,9,0,2133.0
47761,90694,55432,11013,44786,10646,1122,3,1486.0
40319,111068,89702,22295,45634,44068,19800,1369,-3342.0
34128,56810,31259,5693,28360,2899,90,0,2884.0
48273,93364,57871,11630,45962,11909,1440,11,1150.0
45156,109709,80073,18286,50430,29643,8849,258,-2766.0
46014,84700,50550,9852,41988,8562,724,2,2012.0
27352,44168,23668,4211,22070,1598,28,0,2641.0
48365,93548,57953,11636,46090,11863,1368,7,1134.0
48689,97979,62508,12847,47934,14574,2111,13,371.0
29704,48510,26257,4714,24230,2027,50,0,2737.0
46787,86815,52144,10217,42986,9158,843,3,1899.0
46785,87370,52722,10367,43242,9480,886,3,1770.0
47972,104027,70126,15061,49886,20240,4255,66,-990.0
35571,105919,99602,29260,23644,75958,58631,11939,-6.0
36624,108704,96092,26041,35938,60154,36828,4744,-2029.0
30936,50816,27648,4987,25374,2274,68,0,2781.0
48452,103083,68486,14534,49768,18718,3547,42,-679.0
42105,111021,86342,20773,48046,38296,14929,753,-3347.0
37419,63228,35247,6494,31530,3717,168,1,2944.0
48723,95271,59558,12053,46798,12760,1675,11,957.0
43718,78149,45581,8718,38854,6727,441,0,2432.0
47300,106632,73845,16190,50550,23295,5532,104,-1677.0
35999,107647,97635,27263,31692,65943,44263,6859,-1276.0
41100,71986,41330,7806,35824,5506,338,0,2638.0
47642,106408,73145,15938,50662,22483,5084,98,-1559.0
37567,109749,94360,24835,39710,54650,30329,3171,-2657.0
35712,106491,99186,28711,26106,73080,54279,10214,-304.0
48537,99252,64130,13322,48328,15802,2596,23,93.0
35639,105451,100214,30100,19828,80386,65795,15207,302.0
41716,111114,87015,21054,47706,39309,15702,884,-3437.0
43023,110647,84395,19985,48880,35515,12887,571,-3214.0
36005,107762,97624,27221,31922,65702,43918,6791,-1354.0
43312,77599,45373,8701,38540,6833,519,2,2385.0
12492,19236,9867,1686,9618,249,0,0,1437.0
832,1248,624,104,624,0,0,0,104.0
43720,78012,45430,8677,38798,6632,416,0,2461.0
47967,103485,69427,14845,49784,19643,3917,55,-936.0
45751,83410,49441,9587,41360,8081,690,1,2195.0
35709,105361,100427,30342,18802,81625,67757,16041,433.0
36288,108271,97046,26706,33856,63190,40559,5718,-1643.0
48460,103106,68567,14572,49702,18865,3702,60,-651.0
10972,16812,8583,1460,8406,177,0,0,1283.0
48474,99082,64013,13297,48244,15769,2594,14,108.0
47128,106880,74250,16308,50652,23598,5576,96,-1810.0
47333,105944,73053,15969,50292,22761,5360,95,-1527.0
48459,102942,68365,14510,49670,18695,3602,45,-628.0
43650,110668,83437,19563,49496,33941,11676,442,-3144.0
47129,107144,74568,16403,50718,23850,5708,111,-1850.0
36088,107868,97159,26895,32948,64211,41972,6172,-1516.0
48674,96911,61366,12541,47486,13880,1939,12,588.0
43927,110223,82363,19173,49688,32675,10847,451,-3106.0
19266,30207,15759,2736,15102,657,3,0,2082.0
41972,110933,86313,20771,48000,38313,14933,810,-3419.0
48074,104478,70438,15116,50180,20258,4118,58,-1082.0
15700,24288,12513,2147,12144,369,0,0,1778.0
44031,78674,45865,8768,39122,6743,430,1,2454.0
41681,110910,86740,20959,47726,39014,15458,851,-3448.0
46679,87538,53021,10461,43276,9745,986,1,1701.0
35603,105602,100169,29920,20818,79351,63966,14285,250.0
43072,111229,84987,20146,49098,35889,13033,606,-3316.0
35988,60520,33579,6158,30210,3369,100,0,2889.0
46548,107596,75922,16901,50438,25484,6720,164,-2027.0
45408,83574,49889,9727,41416,8473,742,0,1996.0
46882,107754,75739,16809,50624,25115,6506,142,-1942.0
45763,84724,50801,9940,41962,8839,800,1,1900.0
38811,110495,91872,23416,43248,48624,23999,2019,-3228.0
40519,111017,89311,22129,45848,43463,19321,1303,-3316.0
37930,64353,35988,6647,32094,3894,165,0,2918.0
44535,80856,47742,9224,40140,7602,576,1,2197.0
23378,37133,19602,3440,18564,1038,5,0,2407.0
42917,110961,84924,20159,48894,36030,13173,581,-3279.0
35292,58872,32453,5920,29386,3067,100,0,2953.0
47120,89804,55023,10951,44340,10683,1124,4,1388.0
48387,103447,68984,14684,49864,19120,3719,43,-760.0
47921,94688,59597,12117,46492,13105,1704,3,713.0
35720,106720,98800,28373,27362,71438,51996,9504,-573.0
10684,16440,8427,1439,8220,207,0,0,1232.0
37534,109623,94506,24971,39186,55320,31251,3456,-2554.0
36245,108347,96855,26554,34386,62469,39575,5461,-1801.0
48246,93122,57627,11565,45864,11763,1394,10,1186.0
47195,89441,54601,10840,44162,10439,1117,3,1515.0
14988,23308,12067,2080,11654,413,0,0,1667.0
48007,103820,69785,14948,49882,19903,4056,77,-976.0
43733,110476,83026,19414,49568,33458,11340,427,-3131.0
24466,39059,20715,3651,19524,1191,11,0,2471.0
39620,68348,38747,7239,34060,4687,228,0,2780.0
28922,47235,25559,4586,23602,1957,31,0,2660.0
48486,96210,60779,12399,47164,13615,1882,10,656.0
44969,110278,81156,18670,50292,30864,9694,323,-2823.0
35593,106317,99351,28914,25218,74133,55881,10949,-287.0
47267,89754,54861,10901,44316,10545,1122,5,1473.0
45817,108542,77817,17524,50490,27327,7562,191,-2432.0
48611,100664,65659,13744,48854,16805,2956,33,-138.0
46833,107542,75462,16718,50616,24846,6310,147,-1965.0
46749,108753,77045,17202,50878,26167,6997,193,-2161.0
43926,110591,82805,19294,49846,32959,10899,388,-3154.0
48630,95112,59431,12017,46760,12671,1592,6,932.0
35828,107210,98418,27905,29406,69012,48398,8160,-869.0
38888,110524,91963,23472,43094,48869,24336,2084,-3145.0
35685,105462,100287,30173,19536,80751,66390,15475,337.0
41747,110984,86768,20961,47770,38998,15444,837,-3430.0
2480,3748,1888,317,1874,14,0,0,303.0
48685,103122,68240,14429,49906,18334,3310,31,-626.0
42508,110586,85109,20305,48388,36721,13810,668,-3274.0
35627,106084,99648,29256,23760,75888,58564,11997,-65.0
40858,70721,40204,7529,35234,4970,253,0,2812.0
44155,79890,47060,9077,39658,7402,574,1,2248.0
15892,24782,12864,2223,12390,474,2,0,1751.0
47391,106505,73577,16100,50554,23023,5397,111,-1637.0
47707,94417,59520,12120,46320,13200,1777,7,690.0
35828,104719,101042,31592,12532,88510,79655,22178,559.0
8736,13328,6776,1148,6664,112,0,0,1036.0
37160,109276,95199,25417,37896,57303,33484,3932,-2334.0
37102,62705,34939,6431,31292,3647,121,0,2905.0
36118,60923,33892,6230,30404,3488,115,0,2857.0
48430,99305,64287,13374,48330,15957,2645,24,38.0
35708,105238,100511,30504,17998,82513,69242,16756,477.0
35909,104624,101192,32087,9862,91330,84900,25267,390.0
43012,110583,84368,19991,48790,35578,13003,610,-3194.0
36522,61531,34205,6285,30700,3505,131,0,2911.0
42704,76024,44184,8424,37824,6360,376,0,2440.0
37479,109577,94222,24802,39632,54590,30313,3203,-2678.0
43118,76712,44586,8505,38142,6444,428,2,2487.0
45174,110466,81093,18616,50490,30603,9486,314,-2815.0
43353,110776,84011,19802,49210,34801,12356,571,-3214.0
43316,77230,44954,8584,38404,6550,422,0,2456.0
44757,110188,81344,18764,50104,31240,9980,355,-2851.0
43806,110500,82955,19382,49618,33337,11264,430,-3121.0
47780,94129,59153,12018,46198,12955,1733,10,786.0
46984,88486,53730,10617,43758,9972,970,4,1611.0
38004,109926,93510,24381,40734,52776,28458,2856,-2793.0
47119,106932,74403,16373,50568,23835,5796,117,-1783.0
36250,108206,96711,26522,34290,62421,39626,5494,-1767.0
26796,43220,23139,4114,21594,1545,32,0,2601.0
39242,110659,91121,23018,44134,46987,22391,1736,-3314.0
48323,102439,67925,14398,49462,18463,3515,39,-589.0
35625,105846,99721,29450,22742,76979,60362,12783,50.0
48283,102343,67785,14347,49488,18297,3367,39,-622.0
15136,23424,12072,2072,11712,360,0,0,1712.0
48646,95797,60186,12225,47022,13164,1753,4,810.0
38026,109958,93250,24227,41138,52112,27682,2706,-2909.0
48409,99187,64185,13351,48264,15921,2659,33,56.0
47804,106415,73051,15907,50660,22391,5095,78,-1467.0
45341,108836,78785,17878,50302,28483,8232,215,-2588.0
43158,76555,44382,8447,38082,6300,391,0,2538.0
45825,109546,79198,17972,50564,28634,8418,251,-2495.0
48715,101927,66932,14079,49390,17542,3147,43,-359.0
40419,111208,89595,22208,45942,43653,19324,1281,-3402.0
43281,110732,84140,19866,49084,35056,12564,551,-3177.0
48204,95257,60031,12228,46694,13337,1869,10,750.0
36339,108116,96890,26702,33568,63322,40980,5949,-1589.0
44331,80022,47060,9066,39724,7336,574,1,2303.0
42499,111344,86193,20667,48384,37809,14576,753,-3319.0
44296,79730,46777,8993,39596,7181,538,0,2350.0
48204,101566,67046,14161,49126,17920,3314,32,-477.0
35762,104786,100958,31395,13546,87412,77694,21138,539.0
38765,110469,92044,23497,43106,48938,24257,1973,-3157.0
37393,109331,94294,24931,39002,55292,31327,3541,-2575.0
36566,108689,96102,26028,36036,60066,36617,4628,-2049.0
40690,110920,88570,21773,46502,42068,17916,1054,-3433.0
46671,108523,76813,17128,50858,25955,6807,147,-2167.0
46461,108755,77326,17301,50846,26480,7063,153,-2269.0
43884,110426,82827,19348,49566,33261,11294,444,-3063.0
48491,96463,61017,12456,47298,13719,1867,15,589.0
41926,111304,86734,20878,48200,38534,14904,770,-3522.0
36099,108090,97064,26731,33742,63322,40606,5673,-1658.0
38887,110705,92053,23458,43358,48695,23989,1975,-3223.0
48507,97476,62131,12761,47696,14435,2084,9,401.0
24460,39020,20683,3644,19502,1181,16,0,2479.0
36331,108443,96524,26339,35014,61510,38415,5171,-1927.0
42311,110994,85934,20596,48292,37642,14410,709,-3345.0
47484,105402,72150,15668,50292,21858,4818,64,-1436.0
37584,109893,94470,24873,39702,54768,30489,3306,-2712.0
40320,110765,89403,22226,45450,43953,19865,1406,-3268.0
49027,101887,66605,13962,49438,17167,3011,23,-217.0
47721,91249,56103,11205,44976,11127,1297,5,1370.0
45465,83511,49765,9688,41402,8363,707,1,2031.0
35604,105756,99912,29636,22008,77904,61740,13348,124.0
48100,105465,71655,15483,50412,21243,4641,74,-1193.0
35654,106438,99225,28788,25722,73503,54994,10626,-347.0
47551,105377,72159,15694,50154,22005,5069,119,-1361.0
48595,94693,58992,11898,46596,12396,1501,7,996.0
38314,110332,92914,23963,42050,50864,26232,2398,-3067.0
47947,93688,58497,11821,46068,12429,1552,9,935.0
35893,104616,101223,32098,9858,91365,84900,25231,402.0
48572,101032,66037,13836,49058,16979,2916,32,-259.0
43065,76197,44100,8384,37896,6204,405,1,2584.0
36887,108982,95545,25660,37130,58415,34722,4177,-2210.0
42175,111390,86726,20891,48106,38620,15178,829,-3380.0
35615,105783,99890,29597,22198,77692,61387,13167,125.0
48497,102469,67690,14295,49610,18080,3249,41,-577.0
46462,86447,52041,10217,42780,9261,887,4,1839.0
7936,12084,6132,1037,6042,90,0,0,947.0
38468,65626,36856,6830,32732,4124,162,0,2868.0
48654,97047,61538,12591,47530,14008,1987,16,554.0
39937,111023,90303,22574,45162,45141,20699,1489,-3357.0
45472,108996,78906,17917,50310,28596,8376,232,-2535.0
48367,104845,70554,15117,50406,20148,4033,43,-1041.0
44302,110394,82168,19072,49904,32264,10586,390,-2996.0
47121,90125,55381,11050,44462,10919,1201,5,1327.0
41349,110967,87478,21288,47228,40250,16511,977,-3428.0
46546,107861,76091,16917,50680,25411,6501,148,-2141.0
45059,110634,81542,18789,50350,31192,9934,353,-2822.0
39859,111295,90588,22632,45384,45204,20527,1435,-3480.0
48131,102702,68322,14507,49602,18720,3498,41,-756.0
44942,110634,81583,18790,50426,31157,9782,314,-2899.0
37971,110101,93708,24421,40890,52818,28321,2767,-2843.0
37339,109493,94715,25096,38854,55861,31785,3555,-2535.0
39114,110576,91332,23151,43758,47574,23060,1918,-3281.0
46099,109283,78425,17681,50764,27661,7755,215,-2440.0
39985,110898,90000,22451,45294,44706,20310,1419,-3364.0
47747,104465,70932,15329,49890,21042,4685,87,-1115.0
48433,100831,65971,13835,48932,17039,2967,25,-262.0
40838,70535,40034,7488,35140,4894,255,0,2849.0
47025,90493,55849,11180,44618,11231,1257,5,1201.0
48215,94343,58994,11939,46354,12640,1635,7,927.0
37288,63108,35208,6488,31488,3720,132,0,2900.0
48767,96825,61197,12489,47460,13737,1905,7,650.0
36196,107914,97489,27121,32252,65237,43410,6644,-1350.0
43500,110537,83573,19656,49210,34363,12117,530,-3120.0
46760,88110,53586,10611,43506,10080,1098,4,1625.0
35821,104727,101065,31610,12470,88595,79787,22253,549.0
35991,107681,97644,27259,31734,65910,44213,6867,-1305.0
41176,111169,88362,21680,46644,41718,17881,1154,-3311.0
48259,99430,64533,13444,48402,16131,2626,21,-82.0
48288,105570,71479,15391,50612,20867,4346,64,-1194.0
49029,101357,65920,13751,49334,16586,2689,13,-159.0
40526,111154,89287,22085,46064,43223,19026,1314,-3426.0
46826,89209,54683,10893,44008,10675,1193,4,1407.0
42810,110920,84867,20120,49014,35853,12892,522,-3363.0
38635,110278,92162,23607,42682,49480,24914,2129,-3088.0
46856,107718,75679,16785,50648,25031,6422,144,-1968.0
38174,110169,93026,24048,41764,51262,26641,2444,-3017.0
48492,98621,63411,13114,48138,15273,2345,18,168.0
37446,109557,94267,24827,39572,54695,30413,3216,-2671.0
35842,107155,98448,27954,29172,69276,48811,8308,-819.0
47112,107084,74621,16443,50584,24037,5916,116,-1794.0
47869,91869,56652,11343,45246,11406,1377,5,1309.0
45602,109531,79398,18051,50490,28908,8551,276,-2582.0
44044,110493,82609,19235,49808,32801,10877,386,-3075.0
47078,107822,75522,16708,50796,24726,6230,142,-1930.0
46564,86997,52542,10343,43026,9516,945,6,1766.0
41481,110910,87172,21153,47426,39746,16058,875,-3410.0
47242,107825,75315,16622,50898,24417,6029,124,-1890.0
40897,71461,40936,7715,35582,5354,297,1,2657.0
38462,65471,36706,6793,32654,4052,163,0,2904.0
42557,111150,85606,20414,48728,36878,13694,631,-3401.0
41515,72596,41627,7854,36130,5497,336,1,2692.0
37031,109145,95148,25399,37902,57246,33341,3859,-2365.0
48327,104121,69830,14932,50068,19762,3985,51,-896.0
36635,108842,96071,25976,36286,59785,36270,4573,-2112.0
21510,33977,17847,3118,16986,861,5,0,2262.0
46577,87331,52884,10432,43176,9708,979,5,1698.0
39740,69064,39387,7395,34404,4983,256,0,2668.0
38409,110407,92850,23937,42078,50772,26251,2501,-3085.0
48710,101082,66039,13841,49032,17007,3018,26,-174.0
48371,99554,64543,13431,48500,16043,2554,13,-71.0
48517,99249,64079,13295,48388,15691,2473,25,52.0
48539,98995,63785,13214,48286,15499,2423,23,115.0
47959,94592,59503,12100,46406,13097,1780,13,770.0
47876,106533,73136,15929,50698,22438,5137,78,-1450.0
45911,109292,78738,17815,50586,28152,8120,241,-2458.0
48417,97173,61925,12724,47506,14419,2161,21,445.0
48130,93019,57632,11578,45796,11836,1427,4,1165.0
40898,111251,88589,21727,46816,41773,17619,1064,-3491.0
48305,104739,70647,15187,50172,20475,4395,81,-974.0
2552,3848,1934,324,1924,10,0,0,314.0
19052,29924,15639,2720,14958,681,8,0,2047.0
47829,93461,58416,11823,45894,12522,1673,13,961.0
43749,110732,83452,19564,49520,33932,11692,419,-3095.0
48118,92586,57140,11439,45646,11494,1294,6,1233.0
40599,110917,88761,21868,46314,42447,18289,1135,-3425.0
38553,110620,93047,23988,42166,50881,26288,2403,-3008.0
36790,108870,95560,25708,36872,58688,35126,4374,-2228.0
44514,110112,81629,18898,49870,31759,10372,378,-2867.0
46440,108942,77548,17367,50894,26654,7154,188,-2321.0
35731,104938,100703,30942,15754,84949,73430,18869,554.0
36210,107967,97296,26972,32760,64536,42447,6316,-1433.0
40285,111006,89463,22169,45912,43551,19182,1227,-3427.0
46561,86917,52481,10332,42970,9511,977,5,1793.0
23814,37859,20004,3514,18924,1080,11,0,2445.0
42544,110864,85417,20396,48458,36959,13948,684,-3299.0
43635,110600,83272,19496,49568,33704,11464,445,-3189.0
48314,93746,58233,11720,46146,12087,1454,6,1081.0
18592,29104,15162,2629,14550,612,4,0,2021.0
47868,105478,71933,15591,50320,21613,4838,84,-1268.0
47139,107314,74850,16503,50682,24168,5950,113,-1828.0
46322,109051,77852,17479,50830,27022,7391,204,-2356.0
46776,108102,76300,16991,50654,25646,6794,156,-2017.0
29390,47705,25681,4588,23834,1847,37,0,2778.0
19934,31197,16249,2817,15596,653,5,0,2169.0
48012,93727,58529,11835,46048,12481,1631,6,979.0
39480,110947,91174,23003,44330,46844,22287,1742,-3296.0
35846,107114,98282,27878,29296,68986,48522,8278,-864.0
48706,96838,61270,12515,47450,13820,1938,10,623.0
35914,104601,101251,32221,9176,92075,86249,26052,343.0
47078,107198,74751,16477,50640,24111,5918,130,-1846.0
11294,17373,8903,1520,8686,217,1,0,1304.0
43243,110669,84043,19829,49112,34931,12445,555,-3212.0
44704,110736,82085,18993,50212,31873,10312,372,-2940.0
47091,89248,54465,10808,44082,10383,1084,9,1500.0
36474,108700,96245,26115,35800,60445,37100,4866,-2096.0
39922,111111,90460,22629,45146,45314,20819,1492,-3358.0
43816,110488,82842,19334,49680,33162,11128,464,-3164.0
40984,111293,88345,21598,47102,41243,17089,1006,-3562.0
47089,88210,53386,10527,43610,9776,990,3,1738.0
47049,107037,74664,16469,50514,24150,6009,121,-1793.0
29250,47633,25716,4606,23796,1920,41,0,2727.0
34242,57225,31592,5770,28564,3028,97,0,2839.0
48683,100567,65375,13633,48952,16423,2663,15,-142.0
48312,97921,62845,12984,47786,15059,2349,22,252.0
43337,110689,84001,19810,49142,34859,12405,517,-3161.0
38538,110483,92999,24010,41938,51061,26607,2512,-2956.0
44047,110561,82808,19321,49690,33118,11181,411,-3027.0
41145,72061,41346,7801,35886,5460,289,1,2629.0
47713,92488,57403,11544,45542,11861,1404,3,1084.0
36686,61667,34208,6273,30778,3430,111,0,2954.0
47006,107874,75671,16761,50776,24895,6322,146,-1958.0
45531,109895,79962,18233,50526,29436,8843,275,-2635.0
46439,108708,77274,17290,50808,26466,7092,201,-2285.0
44938,82393,49024,9531,40862,8162,669,0,2038.0
45566,83051,49216,9541,41186,8030,679,0,2190.0
45692,109100,78696,17817,50490,28206,8120,260,-2529.0
47616,106049,72869,15886,50422,22447,5205,94,-1450.0
43228,110481,83818,19757,49094,34724,12293,518,-3192.0
46968,107309,75038,16579,50602,24436,6105,130,-1882.0
28984,46916,25194,4491,23442,1752,32,0,2771.0
35935,104548,101336,32609,7018,94318,90512,28689,114.0
36025,107570,97744,27403,31070,66674,45430,7363,-1204.0
22016,34832,18324,3206,17412,912,8,0,2302.0
37397,109540,94692,25070,38964,55728,31612,3475,-2521.0
42335,111302,86257,20687,48392,37865,14518,737,-3397.0
47724,106924,73779,16139,50724,23055,5476,120,-1560.0
37082,109184,95264,25468,37720,57544,33744,3974,-2306.0
45616,109640,79433,18035,50656,28777,8328,212,-2626.0
48157,102833,68509,14570,49598,18911,3637,33,-737.0
39014,110593,91781,23360,43402,48379,23789,1928,-3158.0
14568,22536,11610,1992,11268,342,0,0,1650.0
40824,70858,40357,7567,35312,5045,234,0,2756.0
9336,14244,7242,1227,7122,120,0,0,1107.0
26508,42320,22449,3958,21150,1299,20,0,2679.0
47209,106891,74267,16328,50566,23701,5759,129,-1743.0
48512,96416,61017,12470,47214,13803,1988,12,643.0
47018,108283,76033,16842,51014,25019,6255,152,-2074.0
48378,103302,68838,14646,49800,19038,3702,42,-732.0
47878,105930,72402,15713,50526,21876,4878,78,-1363.0
48881,101891,66801,14042,49350,17451,3191,33,-251.0
31524,51764,28147,5073,25856,2291,52,0,2834.0
42757,110768,84988,20230,48596,36392,13576,667,-3253.0
45934,83891,49806,9672,41580,8226,731,0,2177.0
48553,102577,67851,14356,49566,18285,3445,45,-529.0
37001,109249,95176,25376,38096,57080,33057,3801,-2448.0
45243,110271,80939,18601,50272,30667,9727,351,-2690.0
3208,4848,2442,410,2424,18,0,0,392.0
48593,102042,67138,14137,49454,17684,3134,35,-448.0
39586,110568,90270,22631,44754,45516,21060,1518,-3343.0
36801,62045,34508,6343,30958,3550,129,1,2921.0
43479,78318,45977,8844,38890,7087,538,1,2294.0
37510,109520,94095,24749,39696,54399,30128,3142,-2664.0
39540,110332,90420,22779,44166,46254,22000,1676,-3151.0
47863,93465,58355,11796,45934,12421,1597,15,957.0
46682,108241,76440,17014,50796,25644,6649,152,-2133.0
44196,80310,47460,9177,39858,7602,594,0,2169.0
41088,71468,40780,7659,35606,5174,256,0,2741.0
47826,105289,71690,15512,50308,21382,4673,88,-1285.0
40419,111015,89292,22105,45954,43338,19107,1283,-3409.0
46947,107083,74750,16485,50590,24160,5903,99,-1871.0
18358,28773,15007,2605,14384,623,5,0,1987.0
47635,106199,72945,15888,50562,22383,5075,87,-1507.0
36665,108718,96186,26088,35844,60342,37030,4731,-1955.0
33086,54595,29814,5394,27264,2550,67,0,2911.0
47316,107535,74816,16452,50920,23896,5695,106,-1855.0
41407,111094,87604,21334,47204,40400,16686,1037,-3417.0
48491,97654,62421,12860,47682,14739,2290,13,398.0
37291,109459,94756,25121,38786,55970,31887,3571,-2533.0
47512,106111,73001,15924,50458,22543,5195,98,-1522.0
41190,111355,88478,21683,46858,41620,17639,1072,-3370.0
27370,44293,23780,4238,22132,1648,29,0,2619.0
46167,84604,50326,9783,41954,8372,696,1,2106.0
38542,110214,92400,23755,42270,50130,25674,2326,-3027.0
35574,105632,100013,29781,21340,78673,62952,13886,174.0
35900,104615,101230,32116,9764,91466,85087,25338,399.0
45019,110044,80849,18584,50194,30655,9656,345,-2760.0
47626,105893,72586,15784,50468,22118,4957,88,-1465.0
35626,106563,99099,28606,26562,72537,53439,9952,-444.0
35699,105155,100595,30662,17218,83377,70719,17527,477.0
47272,89974,55086,10959,44418,10668,1138,4,1425.0
47884,105490,71926,15585,50342,21584,4806,72,-1265.0
42435,111459,86447,20760,48334,38113,14791,775,-3337.0
43664,111062,83959,19732,49526,34433,12010,480,-3171.0
35621,105704,100078,29808,21308,78770,63088,13939,187.0
35666,60053,33352,6121,29978,3374,97,0,2844.0
48182,91775,56249,11204,45274,10975,1227,4,1452.0
47353,108421,75962,16812,51052,24910,6317,137,-1918.0
48983,98890,63261,13032,48330,14931,2230,9,322.0
45529,83499,49697,9665,41404,8293,691,1,2062.0
46960,88411,53693,10614,43702,9991,1007,2,1628.0
48044,103762,69707,14926,49858,19849,4046,60,-937.0
48729,98780,63402,13100,48204,15198,2372,23,251.0
35684,105293,100416,30396,18456,81960,68381,16406,411.0
35728,105548,100122,29979,20370,79752,64808,14712,323.0
1324,1996,1003,168,998,5,0,0,163.0
40275,111008,89606,22259,45658,43948,19692,1389,-3386.0
43319,110536,83800,19746,49124,34676,12288,521,-3163.0
46658,106566,74428,16420,50336,24092,5894,122,-1900.0
44993,110260,81028,18611,50390,30638,9480,303,-2850.0
37850,63983,35675,6573,31912,3763,159,0,2969.0
48069,97608,62680,12949,47666,15014,2276,19,192.0
48597,97163,61713,12642,47574,14139,2015,13,505.0
35665,106481,99049,28628,26330,72719,53821,10125,-395.0
35930,107545,97825,27424,31106,66719,45333,7252,-1214.0
47086,106449,73779,16173,50520,23259,5409,80,-1757.0
46202,108140,76947,17235,50484,26463,7172,170,-2226.0
48320,102596,68000,14396,49624,18376,3348,40,-672.0
38636,110419,92329,23671,42632,49697,25155,2254,-3125.0
48606,104119,69485,14794,50206,19279,3707,44,-822.0
45477,110146,80280,18323,50622,29658,8902,279,-2712.0
39866,68653,38864,7252,34216,4648,221,0,2825.0
35808,104804,100948,31368,13688,87260,77428,20952,584.0
48981,101266,65924,13771,49222,16702,2822,23,-132.0
43512,77738,45339,8674,38634,6705,470,0,2439.0
