N0,N1,N2,Volume,Enclosing_surface,Contact_surface,TETRAVOXEL,OCTOVOXEL,MISC_Async
36018,107737,97767,27328,31566,66201,44605,7012,-1280.0
47462,90804,55852,11158,44756,11096,1292,2,1352.0
26476,42538,22688,4019,21262,1426,14,0,2607.0
45726,84138,50213,9788,41698,8515,742,2,2013.0
45443,110323,80467,18368,50726,29741,8871,279,-2781.0
42636,75506,43730,8318,37552,6178,402,0,2542.0
38747,110552,92235,23592,42918,49317,24716,2153,-3162.0
48443,104874,70488,15088,50448,20040,3978,57,-1031.0
15996,24790,12794,2199,12394,400,2,0,1801.0
46731,108163,76364,17002,50716,25648,6731,155,-2070.0
47713,105632,72187,15658,50426,21761,4780,67,-1390.0
46808,107873,75976,16895,50582,25394,6709,194,-1984.0
44643,80772,47561,9168,40114,7447,544,1,2264.0
33854,56053,30707,5572,27982,2725,89,0,2936.0
47127,89188,54361,10775,44072,10289,1044,5,1525.0
43899,110433,82680,19268,49752,32928,10929,391,-3122.0
37012,62490,34800,6404,31176,3624,138,0,2918.0
44042,110728,82961,19361,49756,33205,11216,458,-3086.0
38668,110402,92361,23694,42558,49803,25286,2244,-3067.0
48437,103829,69392,14799,49990,19402,3849,45,-799.0
48519,101561,66746,14051,49186,17560,3189,27,-347.0
46563,86413,51915,10175,42780,9135,853,3,1890.0
35937,104543,101356,32672,6680,94676,91183,29101,78.0
47662,105221,71862,15593,50166,21696,4889,76,-1290.0
46783,87992,53396,10548,43504,9892,984,1,1639.0
48444,96126,60779,12415,47068,13711,1990,12,682.0
13418,20751,10689,1834,10374,315,3,0,1522.0
35752,106882,98556,28130,28332,70224,50218,8828,-704.0
39921,110889,90066,22482,45240,44826,20409,1449,-3384.0
48262,95292,59998,12210,46736,13262,1820,10,758.0
39183,110572,91472,23225,43594,47878,23384,1873,-3142.0
39828,69226,39480,7412,34488,4992,250,0,2670.0
38311,110222,92962,24033,41726,51236,26770,2549,-2982.0
43992,110504,82733,19296,49690,33043,11124,452,-3075.0
47123,107314,74917,16536,50618,24299,6078,125,-1810.0
48083,102922,68701,14637,49580,19121,3762,53,-775.0
46414,85976,51593,10105,42556,9037,864,6,1926.0
48373,101065,66278,13923,49018,17260,3029,29,-337.0
48607,103347,68591,14539,49948,18643,3451,35,-688.0
30766,50277,27225,4889,25116,2109,45,0,2825.0
44438,109869,81233,18746,49990,31243,9889,336,-2944.0
39106,67597,38372,7175,33694,4678,209,0,2706.0
40600,111033,89081,22018,46054,43027,18925,1286,-3370.0
46590,108748,77196,17256,50856,26340,7036,170,-2218.0
42328,74967,43417,8258,37286,6131,395,2,2520.0
19320,30188,15700,2718,15092,608,4,0,2114.0
11908,18276,9345,1592,9138,207,0,0,1385.0
48810,101314,66177,13866,49158,17019,2998,38,-193.0
29494,47989,25887,4633,23976,1911,37,0,2759.0
48769,96891,61276,12513,47474,13802,1943,13,641.0
36370,108397,96732,26509,34410,62322,39577,5568,-1804.0
35678,106516,99188,28725,26026,73162,54464,10402,-375.0
48279,101547,66950,14128,49132,17818,3283,39,-446.0
36456,108687,96381,26174,35718,60663,37251,4786,-2024.0
35868,107531,97839,27406,31242,66597,45047,7086,-1230.0
44556,110426,81802,18906,50168,31634,10090,336,-2974.0
44406,110509,82158,19047,50034,32124,10441,356,-2992.0
47219,90494,55690,11124,44636,11054,1222,1,1291.0
36452,108628,96715,26410,34970,61745,38688,5224,-1871.0
35555,106536,98932,28481,26978,71954,52580,9637,-530.0
35834,106976,98648,28199,28102,70546,50772,9118,-693.0
35858,107210,98009,27677,29956,68053,47298,7942,-1020.0
48687,98740,63364,13085,48218,15146,2304,17,226.0
43546,77805,45384,8684,38664,6720,477,0,2441.0
48326,102490,67919,14384,49534,18385,3422,50,-629.0
47679,106252,72968,15890,50596,22372,5060,73,-1495.0
48452,103881,69396,14791,50046,19350,3789,54,-824.0
40589,111157,89253,22067,46104,43149,18949,1249,-3382.0
48375,95612,60261,12276,46866,13395,1880,13,748.0
48414,104502,70106,14984,50308,19798,3886,38,-966.0
42048,110963,86252,20740,48064,38188,14835,790,-3403.0
13214,20401,10491,1797,10200,291,1,0,1507.0
43377,110440,83509,19628,49250,34259,11940,491,-3182.0
47924,105327,71621,15480,50362,21259,4603,86,-1262.0
47419,92704,57909,11707,45576,12333,1552,9,917.0
47358,90150,55250,11008,44452,10798,1246,6,1450.0
39381,110723,91034,22973,44230,46804,22263,1713,-3281.0
44801,109305,80035,18328,50102,29933,9101,293,-2797.0
44794,110316,81482,18806,50128,31354,10060,358,-2846.0
43587,110595,83473,19601,49340,34133,11915,519,-3136.0
42656,111046,85302,20301,48798,36504,13450,636,-3389.0
15698,24325,12552,2157,12162,390,1,0,1768.0
37590,63629,35507,6545,31744,3763,141,0,2923.0
47298,106735,74001,16244,50538,23463,5659,120,-1680.0
25214,40273,21373,3770,20126,1247,21,0,2544.0
48591,103711,69033,14667,50064,18969,3583,35,-754.0
35591,106492,99118,28653,26318,72800,53856,10145,-436.0
35846,104740,101025,31558,12702,88323,79336,21998,573.0
45575,84252,50464,9866,41732,8732,788,1,1921.0
45558,110086,80124,18269,50634,29490,8818,270,-2673.0
47839,105668,72112,15628,50456,21656,4756,73,-1345.0
42400,75018,43411,8251,37316,6095,386,0,2542.0
30808,50432,27342,4914,25200,2142,32,0,2804.0
48085,105382,71513,15430,50446,21067,4490,67,-1214.0
43355,110391,83282,19519,49450,33832,11491,451,-3273.0
43797,111010,83674,19616,49652,34022,11706,455,-3155.0
35837,107549,97813,27369,31412,66401,44725,6961,-1268.0
47902,92230,56978,11420,45436,11542,1358,6,1230.0
35066,58311,32049,5830,29118,2931,75,0,2974.0
35599,105986,99687,29322,23442,76245,59102,12201,-22.0
47127,106841,74176,16280,50672,23504,5497,91,-1818.0
43117,110887,84578,20033,48958,35620,12971,609,-3225.0
39466,110726,90844,22890,44348,46496,22030,1730,-3306.0
40948,71212,40651,7641,35456,5195,300,0,2746.0
35753,104960,100845,31071,15264,85581,74432,19355,567.0
47188,107666,75167,16582,50842,24325,5982,132,-1893.0
43686,110419,83077,19450,49454,33623,11511,444,-3106.0
48556,101433,66515,13972,49198,17317,3037,26,-334.0
46407,108117,76725,17154,50526,26199,7065,159,-2139.0
46689,108495,76787,17126,50818,25969,6859,161,-2145.0
48093,92053,56594,11296,45412,11182,1229,5,1338.0
42450,110955,85663,20490,48386,37277,14183,728,-3332.0
40773,110873,88456,21748,46424,42032,18025,1133,-3392.0
46612,86770,52253,10261,42940,9313,890,4,1834.0
48161,94918,59657,12120,46594,13063,1730,7,780.0
35609,105816,99945,29641,22044,77901,61728,13371,97.0
45455,109646,79690,18148,50492,29198,8662,261,-2649.0
42870,111177,85180,20226,49004,36176,13169,572,-3353.0
34304,57152,31472,5736,28528,2944,96,0,2888.0
22008,34882,18383,3222,17434,949,14,0,2287.0
48699,100539,65391,13652,48870,16521,2799,31,-101.0
47683,104542,70979,15322,50026,20953,4490,61,-1202.0
38444,110224,92503,23790,42266,50237,25692,2312,-3067.0
43850,110804,83400,19537,49578,33822,11648,454,-3091.0
48729,99945,64708,13462,48644,16064,2657,25,30.0
48228,103259,68879,14660,49798,19081,3663,54,-812.0
47516,91314,56317,11270,45014,11303,1286,4,1249.0
47230,106803,74096,16265,50602,23494,5599,112,-1742.0
34108,56558,31022,5635,28234,2788,90,0,2937.0
48424,101431,66703,14051,49100,17603,3231,34,-355.0
48178,102316,67918,14408,49388,18530,3540,46,-628.0
40789,70911,40446,7594,35328,5118,255,1,2730.0
41887,111287,87041,21038,47854,39187,15579,827,-3397.0
35849,106956,98528,28116,28360,70168,50236,8879,-695.0
38955,110619,91959,23447,43236,48723,24147,2023,-3152.0
44261,79611,46654,8957,39566,7088,479,1,2347.0
46222,108674,77529,17393,50700,26829,7274,154,-2316.0
45349,109448,79603,18138,50378,29225,8692,239,-2634.0
46897,107833,75704,16770,50788,24916,6257,113,-2002.0
38264,110071,92706,23913,41934,50772,26203,2358,-3014.0
48411,101585,66849,14085,49188,17661,3209,43,-410.0
46997,107387,75131,16611,50596,24535,6195,141,-1870.0
46576,87060,52623,10369,43032,9591,996,4,1770.0
45719,84048,50122,9764,41660,8462,728,1,2029.0
43374,77631,45348,8688,38568,6780,495,0,2403.0
35587,106314,99144,28754,25764,73380,54786,10497,-337.0
47482,105270,72025,15641,50204,21821,4862,86,-1404.0
29260,47406,25478,4545,23686,1792,34,0,2787.0
35792,104860,100908,31268,14208,86700,76444,20440,572.0
25510,40863,21738,3842,20424,1314,15,0,2543.0
47761,105133,71602,15497,50222,21380,4689,73,-1267.0
42257,74443,42921,8132,37050,5871,343,1,2603.0
35624,106342,99140,28746,25804,73336,54734,10468,-324.0
39458,110874,90985,22920,44450,46535,21974,1710,-3351.0
45965,108859,78082,17599,50570,27512,7719,217,-2411.0
43469,110444,83311,19533,49424,33887,11596,439,-3197.0
42812,75900,43975,8364,37766,6209,368,0,2523.0
43220,111398,85114,20191,49082,36032,13234,648,-3255.0
47486,106070,73042,15953,50366,22676,5338,110,-1495.0
45580,109594,79531,18097,50480,29051,8634,260,-2580.0
43459,110405,83425,19603,49232,34193,11941,475,-3124.0
47741,92853,57776,11643,45694,12082,1465,5,1021.0
44368,110233,81920,18998,49852,32068,10529,402,-2943.0
47683,91410,56306,11261,45046,11260,1318,1,1318.0
35918,107594,97787,27358,31426,66361,44742,6986,-1247.0
42730,110904,84900,20137,48978,35922,12948,574,-3411.0
43880,110610,83084,19432,49576,33508,11458,460,-3078.0
43628,110980,83683,19606,49730,33953,11520,448,-3275.0
38793,110546,92341,23668,42674,49667,25198,2279,-3080.0
48091,94207,58966,11944,46268,12698,1671,11,906.0
39099,110864,91683,23243,43908,47775,23048,1841,-3325.0
48810,99598,64229,13318,48550,15679,2498,14,123.0
40611,111120,89087,21999,46180,42907,18760,1273,-3421.0
37788,64422,36168,6702,32124,4044,174,0,2832.0
36807,109114,95649,25674,37254,58395,34606,4217,-2332.0
36749,109011,95819,25788,36910,58909,35191,4301,-2231.0
9804,14984,7631,1295,7492,139,0,0,1156.0
41733,111298,87144,21068,47880,39264,15538,831,-3489.0
48172,103934,69704,14896,50032,19672,3870,48,-954.0
46564,87781,53385,10568,43362,10023,1057,2,1600.0
48730,98581,63178,13038,48128,15050,2325,24,289.0
39505,110588,90900,22962,44028,46872,22532,1767,-3145.0
42991,75732,43670,8276,37684,5986,364,1,2653.0
38128,110100,92988,24041,41730,51258,26640,2448,-3025.0
48357,103745,69348,14789,49962,19386,3821,53,-829.0
47002,108052,75840,16800,50880,24960,6292,142,-2010.0
41442,111429,88093,21503,47168,40925,17093,1068,-3397.0
44027,110334,82309,19122,49886,32423,10562,381,-3120.0
48509,97394,62050,12742,47648,14402,2098,15,423.0
35302,58953,32529,5939,29424,3105,105,0,2939.0
47061,107362,74982,16551,50658,24324,6046,143,-1870.0
36753,108835,96007,25971,36188,59819,36459,4657,-2046.0
47288,106563,73732,16147,50582,23150,5399,86,-1690.0
39924,110943,90272,22583,45046,45226,20851,1538,-3330.0
37998,110130,93590,24366,40984,52606,28162,2830,-2908.0
48766,101378,66232,13871,49238,16994,2902,30,-251.0
45683,110090,79968,18203,50718,29250,8654,249,-2642.0
43156,110574,84259,19956,48782,35477,13010,604,-3115.0
37324,109507,94604,25029,39034,55570,31439,3506,-2608.0
35660,106771,98938,28427,27314,71624,52143,9546,-600.0
34860,58254,32146,5867,29090,3056,74,0,2885.0
44834,110821,81936,18907,50430,31506,9961,320,-2958.0
26166,41997,22381,3962,20990,1391,17,0,2588.0
35176,58756,32420,5918,29332,3088,92,0,2922.0
47694,91705,56597,11335,45184,11413,1337,8,1251.0
3928,5944,2998,504,2972,26,0,0,478.0
36562,108623,96150,26094,35736,60414,37151,4836,-2005.0
40278,69863,39784,7461,34802,4982,259,0,2738.0
46881,88190,53510,10568,43612,9898,966,3,1633.0
41712,111224,87303,21170,47586,39717,16052,884,-3379.0
35610,106518,99118,28627,26474,72644,53570,9970,-417.0
35788,107449,97915,27460,31070,66845,45309,7130,-1206.0
47955,105806,72139,15623,50540,21599,4726,85,-1335.0
41492,72466,41492,7816,36088,5404,290,0,2702.0
46664,87506,53009,10462,43246,9763,1014,8,1705.0
43809,110606,83255,19518,49402,33853,11802,527,-3060.0
38030,64599,36160,6684,32216,3944,167,0,2907.0
46569,108367,76730,17112,50788,25942,6791,141,-2180.0
32818,54231,29649,5369,27084,2565,63,0,2867.0
40167,110946,89762,22341,45478,44284,19990,1405,-3358.0
42877,111267,85338,20294,48912,36426,13443,657,-3346.0
35740,104921,100803,31067,15204,85599,74513,19426,555.0
43666,111059,83789,19647,49696,34093,11667,472,-3251.0
36844,108961,95498,25623,37258,58240,34445,4070,-2242.0
48468,99710,64686,13477,48510,16176,2690,24,-33.0
35724,104974,100780,31010,15500,85280,73974,19184,520.0
40182,69373,39349,7354,34574,4775,225,0,2804.0
24934,39889,21199,3744,19934,1265,21,0,2500.0
35660,105916,99729,29452,22746,76983,60424,12872,21.0
35766,107151,98326,27845,29582,68744,47987,7992,-904.0
48344,94342,58923,11920,46326,12597,1690,8,1005.0
48499,102195,67449,14243,49440,18009,3315,39,-490.0
46792,108617,76840,17135,50870,25970,6877,162,-2120.0
39825,68929,39168,7330,34356,4812,217,1,2734.0
43651,111325,84323,19855,49516,34807,12293,547,-3206.0
24340,38798,20550,3618,19392,1158,14,0,2474.0
46992,107782,75460,16674,50876,24584,6030,124,-2004.0
47926,105326,71670,15506,50304,21366,4718,94,-1236.0
48178,105106,71067,15286,50418,20649,4270,54,-1147.0
37038,109186,95139,25396,37902,57237,33382,3946,-2405.0
35716,106798,98805,28349,27516,71289,51766,9452,-626.0
35918,107543,97735,27343,31412,66323,44719,6972,-1233.0
42046,73845,42479,8034,36754,5725,337,0,2646.0
47443,107673,74865,16461,50964,23901,5745,131,-1826.0
47456,106237,73102,15934,50600,22502,5037,82,-1613.0
36595,108537,96046,26056,35756,60290,37025,4743,-1952.0
44040,110066,82107,19092,49662,32445,10742,400,-3011.0
15374,23861,12331,2122,11930,401,1,0,1722.0
35621,105872,99897,29550,22494,77403,60884,12935,96.0
42196,74280,42799,8104,36974,5825,332,0,2611.0
40309,69653,39533,7392,34714,4819,225,1,2797.0
6388,9716,4925,832,4858,67,0,0,765.0
37597,109771,93830,24531,40474,53356,28823,2873,-2875.0
36605,108650,96089,26055,35848,60241,36954,4779,-2011.0
44185,110540,82453,19164,49922,32531,10696,395,-3066.0
45542,109519,79463,18072,50494,28969,8531,220,-2586.0
43787,110661,83393,19566,49390,34003,11881,491,-3047.0
35793,107297,98035,27604,30446,67589,46405,7493,-1073.0
48266,96402,61172,12520,47224,13948,1954,10,516.0
47983,104561,70653,15192,50154,20499,4253,63,-1117.0
37725,109991,94076,24612,40480,53596,29031,2849,-2802.0
39336,110669,91102,23015,44114,46988,22441,1714,-3246.0
48204,100781,66171,13922,48810,17361,3161,50,-328.0
20418,32073,16762,2915,16034,728,5,0,2192.0
35562,106176,99475,29040,24710,74765,56756,11210,-179.0
3120,4700,2360,395,2350,10,0,0,385.0
37662,63731,35544,6547,31806,3738,119,0,2928.0
45553,109416,79274,18008,50500,28774,8416,247,-2597.0
37271,109575,95123,25304,38422,56701,32731,3819,-2485.0
48103,93274,57900,11645,45930,11970,1414,5,1084.0
37964,109891,93506,24380,40732,52774,28427,2834,-2801.0
44444,80572,47523,9174,40002,7521,568,0,2221.0
47538,107071,74100,16239,50766,23334,5539,116,-1672.0
44966,110310,81082,18623,50426,30656,9458,310,-2885.0
45434,109968,80249,18345,50428,29821,9112,266,-2630.0
48924,102236,67040,14081,49594,17446,3048,36,-353.0
47453,91650,56722,11381,45158,11564,1334,7,1144.0
29592,48192,26016,4659,24078,1938,36,0,2757.0
41668,73060,41963,7925,36376,5587,308,0,2646.0
36673,108914,96224,26057,36106,60118,36702,4715,-2074.0
47342,89316,54324,10751,44142,10182,1032,2,1599.0
48562,98682,63480,13144,48096,15384,2490,34,216.0
29852,48734,26366,4731,24346,2020,42,0,2753.0
12882,19905,10244,1756,9952,292,1,0,1465.0
48560,100293,65267,13633,48736,16531,2821,22,-99.0
41504,72524,41540,7827,36118,5422,288,0,2693.0
35620,106223,99324,28954,24924,74400,56375,11162,-233.0
35937,104545,101364,32704,6504,94860,91537,29329,52.0
36060,107943,97298,26920,33076,64222,41791,5994,-1505.0
26402,42569,22776,4046,21276,1500,17,0,2563.0
48078,104541,70507,15134,50210,20297,4121,48,-1090.0
44733,80705,47399,9115,40108,7291,489,1,2312.0
35671,105303,100405,30374,18566,81839,68171,16307,399.0
47552,90660,55568,11064,44752,10816,1156,8,1396.0
2180,3276,1641,274,1638,3,0,0,271.0
36159,108116,97078,26760,33596,63482,40924,5841,-1639.0
48563,102792,68008,14381,49730,18278,3332,37,-602.0
46525,106493,74528,16472,50224,24304,6045,125,-1912.0
48541,100707,65706,13747,48930,16776,2847,25,-207.0
45853,108971,78336,17682,50580,27756,7811,201,-2464.0
41356,72422,41550,7839,36066,5484,290,0,2645.0
48081,103257,69067,14736,49718,19349,3821,53,-845.0
48022,91916,56559,11304,45294,11265,1328,6,1361.0
37439,109719,94749,25056,39162,55587,31395,3451,-2587.0
44890,109806,80693,18543,50128,30565,9550,294,-2766.0
45318,82772,49106,9525,41062,8044,648,2,2127.0
48771,104499,69806,14881,50326,19480,3847,51,-803.0
42022,110529,85727,20582,47962,37765,14605,784,-3362.0
38434,65847,37113,6899,32832,4281,183,0,2801.0
42330,111036,85902,20568,48396,37506,14244,678,-3372.0
44926,109547,80159,18346,50242,29917,9063,300,-2808.0
37179,109257,94865,25229,38356,56509,32545,3707,-2442.0
47453,91025,56087,11220,44854,11233,1317,9,1295.0
37017,109331,95180,25350,38260,56920,32811,3725,-2484.0
44649,110400,81806,18935,50002,31804,10396,407,-2880.0
628,944,473,79,472,1,0,0,78.0
38087,110054,93461,24335,40912,52549,28230,2857,-2841.0
44402,110579,82349,19128,49930,32419,10719,384,-2956.0
37215,109478,94917,25184,38730,56187,32018,3545,-2530.0
44755,110245,81317,18733,50236,31081,9773,331,-2906.0
39584,68072,38492,7176,33928,4564,216,0,2828.0
38686,66591,37672,7024,33200,4472,191,0,2743.0
42764,75652,43771,8318,37634,6137,384,0,2565.0
43005,111206,85098,20199,49002,36096,13202,607,-3302.0
38942,110506,91707,23345,43344,48363,23818,2002,-3202.0
47871,105421,71771,15524,50398,21373,4625,79,-1303.0
47542,106676,73670,16120,50620,23050,5436,90,-1584.0
21746,34409,18102,3167,17202,900,5,0,2272.0
48324,102772,68194,14449,49694,18500,3384,36,-703.0
40778,110893,88570,21805,46310,42260,18273,1168,-3350.0
36330,108408,96876,26545,34482,62394,39444,5342,-1747.0
34934,58489,32339,5914,29194,3145,101,0,2870.0
36239,108040,96984,26743,33510,63474,41020,5849,-1560.0
48816,101837,66744,14019,49374,17370,3089,34,-296.0
47239,106634,73830,16174,50616,23214,5402,101,-1739.0
48589,102023,67196,14170,49372,17824,3279,33,-408.0
37439,109522,94301,24864,39418,54883,30686,3313,-2646.0
43767,110965,83703,19647,49524,34179,11917,527,-3142.0
36112,108026,97298,26951,32890,64408,42246,6356,-1567.0
47114,107169,74756,16492,50560,24196,6049,136,-1791.0
48332,95125,59760,12142,46668,13092,1789,14,825.0
36587,108583,96368,26235,35326,61042,37931,4987,-1863.0
39611,110710,90327,22625,44904,45423,20902,1501,-3397.0
46304,85688,51357,10045,42444,8913,800,4,1928.0
45813,109262,78789,17833,50580,28209,8102,219,-2493.0
46299,109225,78148,17584,50792,27356,7641,231,-2362.0
5264,7976,4028,678,3988,40,0,0,638.0
46578,108809,77323,17304,50822,26501,7165,180,-2212.0
36289,108296,97095,26719,33876,63219,40544,5675,-1631.0
37123,109333,94809,25151,38712,56097,31909,3515,-2552.0
37785,109685,93819,24610,39978,53841,29729,3189,-2691.0
48023,94096,58900,11930,46220,12680,1656,9,897.0
46735,108891,77236,17255,50942,26294,7007,143,-2175.0
48308,104049,69793,14931,50000,19793,4049,66,-879.0
47787,103535,69754,14974,49664,20090,4207,59,-968.0
48435,103574,69090,14711,49914,19176,3746,41,-760.0
48182,104524,70447,15123,50156,20291,4212,62,-1018.0
46103,108796,77877,17531,50568,27309,7660,229,-2347.0
6916,10508,5321,898,5254,67,0,0,831.0
35823,104799,100974,31429,13374,87600,78051,21311,569.0
47395,107741,74969,16486,51022,23947,5697,99,-1863.0
48354,100491,65592,13720,48864,16728,2763,20,-265.0
48758,101378,66330,13919,49146,17184,3086,30,-209.0
37792,64084,35818,6612,31964,3854,156,0,2914.0
43896,110369,82562,19230,49744,32818,10881,434,-3141.0
48621,100158,65072,13578,48676,16396,2806,31,-43.0
37600,109740,93880,24578,40292,53588,29156,2984,-2838.0
47048,88265,53484,10557,43626,9858,1013,2,1710.0
9088,13896,7080,1202,6948,132,0,0,1070.0
47017,88855,54138,10733,43878,10260,1099,5,1567.0
41307,111212,88034,21506,47032,41002,17148,1029,-3377.0
48169,98643,63769,13248,48050,15719,2543,25,47.0
47796,93082,57966,11688,45804,12162,1474,8,992.0
37514,109846,94420,24829,39866,54554,30114,3130,-2741.0
44813,110388,81520,18808,50192,31328,10004,347,-2863.0
3164,4764,2391,400,2382,9,0,0,391.0
35336,58934,32479,5923,29420,3059,94,0,2958.0
46517,85977,51478,10060,42596,8882,785,5,1958.0
45895,108834,78120,17614,50556,27564,7722,205,-2433.0
44262,110328,82166,19079,49858,32308,10612,362,-2979.0
31700,52078,28330,5108,26012,2318,54,0,2844.0
48509,96153,60652,12353,47186,13466,1781,13,655.0
41803,111233,87163,21105,47696,39467,15841,851,-3372.0
10624,16308,8340,1421,8154,186,0,0,1235.0
45806,84253,50300,9813,41722,8578,809,4,2040.0
47124,88673,53849,10647,43816,10033,1041,2,1653.0
38740,110564,92126,23524,43108,49018,24348,2076,-3222.0
35878,104656,101160,31955,10590,90570,83476,24434,427.0
46794,107444,75338,16672,50644,24694,6156,118,-1984.0
35618,105669,99947,29737,21472,78475,62725,13828,159.0
28108,45534,24466,4363,22754,1712,26,0,2677.0
48472,99540,64473,13414,48462,16011,2616,28,-9.0
47098,108142,75863,16800,50926,24937,6290,134,-1981.0
47456,90946,56007,11200,44814,11193,1318,8,1317.0
38624,110425,92473,23748,42458,50015,25509,2318,-3076.0
45300,82711,49078,9524,41012,8066,687,2,2143.0
42321,111076,86039,20635,48268,37771,14540,755,-3351.0
48682,99839,64613,13436,48610,16003,2619,32,20.0
43466,78255,45909,8824,38874,7035,507,0,2296.0
43737,78115,45527,8702,38842,6685,431,1,2447.0
35548,105919,99811,29437,23000,76811,59919,12542,3.0
48966,100451,64970,13496,48964,16006,2523,24,-11.0
43565,78161,45731,8771,38836,6895,489,1,2364.0
42354,110964,85942,20613,48206,37736,14552,710,-3281.0
48692,98961,63625,13162,48278,15347,2405,26,194.0
46060,109268,78433,17682,50774,27659,7720,200,-2457.0
19422,30507,15942,2772,15252,690,3,0,2085.0
47847,105953,72419,15712,50566,21853,4821,79,-1399.0
48031,104963,71064,15303,50310,20754,4343,63,-1171.0
35672,106940,98613,28129,28452,70161,50036,8788,-784.0
40986,111181,88498,21716,46700,41798,17781,1112,-3413.0
47788,91636,56467,11299,45140,11327,1356,8,1320.0
47901,107029,73594,16042,50936,22658,5157,117,-1576.0
47718,107212,74106,16227,50850,23256,5512,98,-1615.0
44991,81653,48230,9326,40504,7726,645,3,2242.0
48451,101888,67186,14181,49286,17900,3316,29,-432.0
37081,109435,95045,25264,38506,56539,32423,3721,-2573.0
44655,109990,81100,18676,50144,30956,9702,333,-2911.0
35864,104637,101177,31931,10768,90409,83101,24150,473.0
48304,104555,70406,15110,50152,20254,4251,62,-955.0
48433,102927,68358,14507,49674,18684,3579,45,-643.0
40331,110971,89561,22245,45652,43909,19667,1327,-3324.0
35937,104544,101364,32709,6474,94890,91596,29367,48.0
39957,110763,89663,22306,45490,44173,19783,1365,-3449.0
37655,109855,94049,24644,40234,53815,29387,3011,-2795.0
47592,91185,56140,11223,44942,11198,1301,2,1324.0
35654,106437,99150,28719,25986,73164,54465,10372,-352.0
43570,110816,83946,19786,49176,34770,12464,566,-3086.0
48588,103079,68402,14510,49744,18658,3591,42,-599.0
35768,104835,100850,31202,14488,86362,75859,20118,581.0
43738,110713,83279,19481,49672,33607,11369,420,-3177.0
48323,96139,60820,12417,47138,13682,1863,11,587.0
37812,109892,93596,24402,40780,52816,28332,2804,-2886.0
10882,16693,8532,1453,8346,186,1,0,1268.0
47650,91291,56154,11211,45042,11112,1207,4,1302.0
48572,100595,65474,13664,48964,16510,2667,34,-213.0
37294,109422,94584,25029,38994,55590,31434,3446,-2573.0
47572,105365,72087,15659,50220,21867,4925,82,-1365.0
48535,103992,69470,14809,50086,19384,3820,41,-796.0
45381,109649,79756,18170,50492,29264,8665,253,-2682.0
47717,91065,55906,11152,44900,11006,1265,5,1406.0
3900,5888,2963,497,2944,19,0,0,478.0
42433,75273,43654,8313,37430,6224,413,1,2501.0
39172,110680,91641,23306,43446,48195,23788,2072,-3173.0
43430,76847,44466,8450,38232,6234,383,0,2599.0
20586,32393,16956,2953,16194,762,5,0,2196.0
48104,93908,58627,11850,46154,12473,1600,4,973.0
40467,110856,88923,21961,46080,42843,18696,1241,-3427.0
48421,103845,69372,14784,50040,19332,3765,53,-836.0
35767,107388,97768,27379,31262,66506,44864,6969,-1232.0
35798,107116,98296,27871,29366,68930,48384,8218,-893.0
39322,110668,90890,22916,44284,46606,22100,1782,-3372.0
35779,107000,98459,28034,28714,69745,49572,8657,-796.0
47529,90696,55683,11109,44712,10971,1272,3,1407.0
44647,80435,47201,9073,39964,7237,507,3,2340.0
46131,108848,77888,17522,50644,27244,7560,189,-2351.0
27770,44885,24078,4289,22422,1656,41,0,2674.0
45229,82640,49046,9517,40990,8056,660,3,2118.0
43352,110623,83753,19697,49324,34429,11975,458,-3215.0
33450,55395,30339,5502,27666,2673,63,0,2892.0
38922,110419,91457,23215,43624,47833,23171,1808,-3255.0
47612,106102,72921,15899,50448,22473,5206,100,-1468.0
12118,18685,9597,1642,9342,255,1,0,1388.0
43116,110829,84393,19946,49110,35283,12609,538,-3266.0
37689,109635,94255,24851,39404,54851,30827,3369,-2542.0
41619,111209,87369,21201,47532,39837,16145,931,-3422.0
38281,110201,92909,23984,41914,50995,26373,2357,-2995.0
37702,109894,94016,24620,40312,53704,29270,2982,-2796.0
46028,108195,77260,17360,50360,26900,7475,202,-2267.0
35899,107511,97783,27393,31208,66575,45095,7135,-1222.0
40128,111094,89822,22319,45730,44092,19634,1324,-3463.0
46915,88517,53809,10640,43778,10031,961,3,1567.0
47717,105745,72400,15742,50348,22052,5049,109,-1370.0
42463,111048,85805,20533,48412,37393,14224,677,-3313.0
44614,110354,81677,18869,50140,31537,10074,338,-2932.0
41049,111407,88493,21654,47062,41431,17283,1025,-3519.0
13088,20192,10376,1776,10096,280,0,0,1496.0
44477,110187,81689,18904,49954,31735,10279,373,-2925.0
36504,61254,33929,6214,30574,3355,106,0,2965.0
23720,37796,20010,3521,18894,1116,8,0,2413.0
46836,108308,76283,16935,50956,25327,6396,128,-2124.0
41362,111193,87743,21361,47320,40423,16553,940,-3449.0
45752,84116,50163,9772,41694,8469,728,4,2027.0
36276,108271,96719,26518,34330,62389,39611,5534,-1794.0
35918,104557,101287,32398,8186,93101,88185,27232,250.0
44662,110075,81390,18808,49932,31458,10211,392,-2831.0
3640,5492,2762,463,2746,16,0,0,447.0
48164,92476,57022,11413,45566,11456,1344,4,1297.0
36379,108306,97115,26763,33652,63463,41002,5877,-1575.0
45245,109895,80105,18263,50632,29473,8631,229,-2808.0
38344,65302,36623,6779,32572,4051,158,0,2886.0
48255,99127,64247,13377,48232,16015,2663,27,-2.0
36210,60687,33579,6144,30294,3285,99,0,2958.0
48444,96063,60581,12331,47176,13405,1711,6,631.0
48843,102166,67069,14103,49520,17549,3126,37,-357.0
46628,107895,76086,16917,50670,25416,6555,154,-2098.0
42820,75884,43979,8371,37732,6247,420,0,2544.0
48895,97357,61661,12605,47692,13969,1973,15,594.0
43818,110599,83092,19427,49622,33470,11355,428,-3116.0
38273,110100,92792,23958,41836,50956,26428,2423,-2993.0
43342,111138,84658,20038,49088,35570,12962,606,-3176.0
43281,76927,44675,8516,38254,6421,419,1,2513.0
33322,55043,30087,5448,27486,2601,71,0,2918.0
48305,93708,58232,11728,46096,12136,1516,7,1101.0
39511,110992,91075,22935,44540,46535,21912,1653,-3341.0
10832,16576,8452,1436,8288,164,0,0,1272.0
47552,105763,72522,15774,50400,22122,4963,78,-1463.0
44258,110539,82441,19164,49898,32543,10743,368,-3004.0
39895,69092,39286,7357,34430,4856,232,1,2732.0
8716,13344,6807,1157,6672,135,0,0,1022.0
48397,94640,59120,11950,46540,12580,1560,3,927.0
42102,73703,42280,7977,36698,5582,307,0,2702.0
47891,105730,72120,15623,50502,21618,4726,73,-1342.0
1652,2484,1245,208,1242,3,0,0,205.0
48747,101527,66404,13916,49312,17092,2903,19,-292.0
45279,109655,79923,18242,50394,29529,8867,275,-2695.0
46897,107698,75568,16738,50708,24860,6282,131,-1971.0
42563,110863,85197,20280,48714,36483,13435,615,-3383.0
37517,109598,94147,24759,39740,54407,30118,3163,-2693.0
48080,93430,58114,11710,45968,12146,1494,4,1054.0
46005,84694,50551,9853,41984,8567,726,3,2009.0
39920,111113,90624,22730,44868,45756,21377,1650,-3299.0
35608,60040,33400,6141,29954,3446,132,0,2827.0
37455,109706,94829,25113,38980,55849,31746,3545,-2535.0
37154,109484,95282,25407,38122,57160,33240,3942,-2455.0
36693,108890,95940,25894,36516,59424,35858,4479,-2151.0
31612,51890,28208,5083,25918,2290,54,0,2847.0
42163,111015,86207,20712,48142,38065,14731,735,-3357.0
46220,109157,78118,17569,50822,27296,7513,174,-2388.0
42448,110867,85592,20474,48340,37252,14187,710,-3301.0
41760,111396,87363,21167,47724,39639,15948,916,-3440.0
44477,109989,81461,18837,49900,31561,10189,353,-2888.0
48340,95797,60447,12318,46986,13461,1825,10,672.0
35646,106511,99173,28687,26224,72949,54063,10180,-379.0
37116,109339,94984,25261,38402,56582,32535,3714,-2500.0
44270,110728,82508,19153,50098,32410,10532,378,-3103.0
41674,111017,87065,21095,47560,39505,15897,860,-3373.0
35650,106795,98741,28261,27916,70825,50963,9064,-665.0
48281,96134,60914,12460,47068,13846,1998,11,601.0
48431,101745,67020,14132,49248,17772,3249,35,-426.0
47646,92276,57262,11518,45416,11846,1444,2,1114.0
47482,92018,57136,11500,45272,11864,1474,10,1100.0
45891,84602,50558,9865,41926,8632,750,1,1982.0
37338,63277,35342,6519,31570,3772,137,0,2884.0
29566,48283,26132,4691,24118,2014,47,0,2724.0
38976,110602,91471,23189,43808,47663,22986,1856,-3344.0
48789,102779,67834,14326,49712,18122,3355,41,-482.0
48621,102439,67590,14267,49578,18012,3283,33,-495.0
48297,93592,58074,11677,46086,11988,1420,7,1102.0
47062,106516,73991,16264,50398,23593,5720,118,-1727.0
35760,104988,100768,31007,15494,85274,74000,19200,533.0
47965,92928,57650,11589,45766,11884,1396,3,1098.0
43393,110822,84019,19793,49280,34739,12262,519,-3203.0
48275,102854,68350,14501,49694,18656,3466,41,-730.0
48317,102874,68318,14485,49726,18592,3422,39,-724.0
46419,108085,76635,17120,50550,26085,6985,171,-2151.0
30468,49928,27111,4882,24930,2181,68,0,2769.0
20100,31638,16564,2885,15818,746,2,0,2141.0
46797,87628,53002,10444,43340,9662,948,3,1727.0
46400,87254,52914,10444,43164,9750,926,4,1616.0
48586,103443,68737,14588,49946,18791,3551,56,-708.0
39357,110846,91144,22986,44372,46772,22102,1647,-3331.0
36903,108876,95201,25513,37324,57877,34228,4149,-2285.0
32,48,24,4,24,0,0,0,4.0
44860,109721,80549,18489,50164,30385,9393,298,-2801.0
48309,95315,59946,12184,46788,13158,1739,9,756.0
43549,110565,83472,19597,49362,34110,11841,469,-3141.0
36321,108193,96875,26641,33904,62971,40385,5693,-1638.0
38988,66836,37679,7004,33334,4345,168,0,2827.0
46113,109437,78573,17715,50856,27717,7725,189,-2466.0
35631,105719,99983,29738,21538,78445,62643,13779,157.0
43084,111419,85218,20212,49164,36054,13091,578,-3329.0
35706,107001,98446,27991,28946,69500,49109,8440,-840.0
44073,110700,82852,19315,49814,33038,11072,439,-3090.0
24152,38552,20448,3605,19266,1182,20,0,2443.0
33448,55578,30535,5554,27746,2789,86,0,2851.0
47442,105056,71813,15582,50134,21679,4788,74,-1383.0
48682,99525,64247,13330,48514,15733,2497,20,74.0
46270,86079,51822,10175,42594,9228,891,0,1838.0
43335,77764,45520,8736,38624,6896,516,1,2355.0
35750,106907,98579,28138,28330,70249,50247,8852,-716.0
6544,9936,5028,848,4968,60,0,0,788.0
38057,109830,93129,24206,41022,52107,27786,2735,-2850.0
30536,49948,27064,4862,24956,2108,36,0,2790.0
29781,48479,26164,4685,24218,1946,43,1,2781.0
35929,104551,101309,32471,7792,93517,88967,27705,216.0
40315,110855,89307,22145,45744,43563,19367,1327,-3378.0
43618,110791,83756,19699,49318,34438,12155,532,-3116.0
47221,108446,76033,16822,51134,24899,6178,115,-2014.0
48817,99681,64348,13361,48530,15818,2621,41,123.0
16410,25565,13258,2289,12782,476,1,0,1814.0
46298,109035,77887,17494,50810,27077,7415,176,-2344.0
46204,109024,77978,17530,50776,27202,7472,172,-2372.0
36101,107804,97603,27212,31934,65669,43936,6791,-1312.0
38017,110087,93478,24315,41066,52412,27955,2765,-2907.0
48374,94852,59386,12028,46604,12782,1644,10,880.0
42001,73815,42489,8041,36732,5757,351,1,2634.0
47472,92002,57135,11502,45258,11877,1486,8,1103.0
45200,109564,79922,18254,50320,29602,8924,272,-2696.0
48742,103094,68209,14429,49844,18365,3406,42,-572.0
43742,78103,45526,8705,38822,6704,459,0,2460.0
42685,111112,85438,20357,48734,36704,13644,643,-3346.0
31848,52198,28339,5101,26072,2267,54,0,2888.0
37514,109592,94058,24709,39862,54196,29868,3110,-2729.0
47155,107516,75011,16536,50806,24205,5904,121,-1886.0
48491,98984,63822,13228,48276,15546,2432,13,101.0
42278,110827,85723,20528,48278,37445,14271,708,-3354.0
14714,22789,11754,2019,11394,360,1,0,1660.0
38737,110628,92228,23569,43042,49186,24544,2159,-3232.0
38128,110163,93163,24118,41618,51545,26927,2490,-2990.0
46607,86326,51753,10121,42780,8973,766,1,1913.0
47657,106858,73738,16122,50744,22994,5370,83,-1585.0
43000,111023,84931,20157,48920,36011,13183,578,-3249.0
41350,111079,87575,21307,47308,40267,16463,964,-3461.0
35916,107246,98229,27789,29724,68505,47798,7972,-890.0
48385,104879,70614,15142,50376,20238,4127,53,-1022.0
42890,111042,85054,20203,48890,36164,13262,602,-3301.0
36061,107971,97274,26929,32974,64300,42023,6217,-1565.0
48690,99068,63743,13193,48328,15415,2412,18,172.0
39582,68139,38566,7196,33956,4610,227,0,2813.0
46089,85429,51250,10029,42326,8924,777,1,1881.0
42640,74850,43029,8132,37266,5763,318,0,2687.0
48091,102469,68119,14458,49490,18629,3489,35,-717.0
35690,106622,98775,28391,27204,71571,52214,9582,-548.0
45347,109403,79517,18109,50380,29137,8643,263,-2648.0
35765,104980,100823,31063,15268,85555,74444,19407,545.0
27116,43742,23418,4163,21858,1560,26,0,2629.0
48479,102681,67979,14384,49654,18325,3373,39,-607.0
46551,108985,77534,17363,50890,26644,7205,187,-2263.0
45810,109913,79527,18038,50826,28701,8261,212,-2614.0
48525,102211,67445,14240,49450,17995,3311,37,-481.0
47705,105933,72530,15755,50530,22000,4873,81,-1453.0
43010,110985,84910,20162,48848,36062,13289,616,-3227.0
48377,95023,59623,12104,46622,13001,1779,9,873.0
47508,106339,73311,16022,50490,22821,5359,102,-1542.0
48321,100090,65190,13616,48684,16506,2722,27,-195.0
44531,80228,47069,9044,39874,7195,480,1,2328.0
48313,103341,68927,14674,49810,19117,3721,53,-775.0
34452,57144,31337,5689,28540,2797,64,0,2956.0
46596,108341,76669,17097,50756,25913,6829,186,-2173.0
14532,22518,11620,1997,11258,362,2,0,1637.0
47029,108288,76091,16868,50974,25117,6340,127,-2036.0
33430,55291,30256,5484,27608,2648,75,0,2911.0
46478,108144,76579,17084,50654,25925,6836,166,-2171.0
35753,106713,98700,28293,27642,71058,51429,9217,-553.0
39033,110595,91953,23469,43092,48861,24411,2097,-3078.0
9156,14020,7153,1216,7010,143,0,0,1073.0
38214,110036,92722,23930,41864,50858,26308,2410,-3030.0
48056,104932,71029,15297,50276,20753,4380,68,-1144.0
44692,110302,81420,18764,50256,31164,9790,344,-2954.0
46423,86111,51717,10134,42630,9087,851,3,1895.0
39665,110901,90681,22773,44724,45957,21453,1597,-3328.0
46094,85372,51220,10029,42266,8954,840,2,1913.0
34692,57858,31890,5817,28878,3012,102,0,2907.0
39419,110753,90918,22908,44388,46530,21977,1679,-3324.0
36829,109079,95590,25636,37364,58226,34351,4057,-2296.0
45654,109501,79231,17976,50606,28625,8289,232,-2592.0
44924,109963,80794,18561,50222,30572,9519,314,-2806.0
44191,110669,82680,19248,49872,32808,10925,411,-3046.0
45893,84191,50106,9742,41760,8346,671,1,2066.0
47168,88777,53940,10672,43848,10092,1081,2,1659.0
47882,92767,57579,11584,45654,11925,1459,8,1110.0
46050,85465,51350,10065,42310,9040,845,0,1870.0
48330,93172,57567,11532,45942,11625,1288,2,1193.0
17768,27792,14468,2507,13894,574,4,0,1937.0
39358,67681,38271,7135,33732,4539,217,0,2813.0
38538,110356,92527,23783,42356,50171,25644,2330,-3074.0
43456,77032,44636,8492,38320,6316,392,0,2568.0
48329,101253,66536,14000,49072,17464,3109,33,-388.0
25178,40279,21401,3778,20134,1267,11,0,2522.0
48395,97345,62146,12789,47558,14588,2229,23,407.0
47201,106920,74285,16326,50614,23671,5692,107,-1760.0
22034,34891,18369,3216,17442,927,7,0,2296.0
46759,107633,75561,16734,50718,24843,6197,135,-2047.0
47568,106117,72942,15899,50490,22452,5137,90,-1506.0
47731,105892,72460,15734,50516,21944,4860,85,-1435.0
41659,73124,42043,7948,36398,5645,328,1,2630.0
45857,84778,50786,9931,41986,8800,806,3,1934.0
43122,110716,84410,19995,48850,35560,13016,630,-3179.0
48475,104238,69800,14906,50164,19636,3910,49,-869.0
44744,80766,47465,9134,40126,7339,514,0,2309.0
46249,85365,51054,9967,42306,8748,753,1,1971.0
35734,106929,98955,28375,27660,71295,51609,9304,-615.0
46289,86336,52055,10230,42730,9325,876,3,1778.0
44602,109664,80833,18613,49988,30845,9688,298,-2842.0
44851,109809,80577,18481,50268,30309,9273,307,-2862.0
18730,29339,15293,2653,14668,625,3,0,2031.0
44165,110086,81991,19044,49718,32273,10650,395,-2974.0
42663,110842,85067,20235,48724,36343,13394,633,-3347.0
47454,107707,74853,16444,51042,23811,5623,100,-1844.0
37096,109479,94980,25191,38814,56166,31851,3470,-2594.0
30962,50843,27653,4986,25390,2263,63,0,2786.0
48526,102260,67464,14237,49506,17958,3248,34,-507.0
11986,18401,9412,1604,9200,212,1,0,1393.0
47083,106728,74105,16268,50602,23503,5524,97,-1808.0
47696,106212,72948,15894,50532,22416,5148,88,-1462.0
23382,37223,19694,3464,18604,1090,15,0,2389.0
28708,46486,24970,4452,23228,1742,30,0,2740.0
42841,75575,43623,8273,37608,6015,359,1,2616.0
48104,103263,69080,14744,49696,19384,3871,54,-823.0
36252,108193,97058,26743,33658,63400,40877,5846,-1626.0
48104,94267,59017,11956,46298,12719,1671,10,898.0
44555,110538,81966,18962,50160,31806,10218,353,-2979.0
35654,106339,99306,28886,25296,74010,55747,10888,-265.0
43139,110789,84201,19861,49236,34965,12317,523,-3310.0
44370,110722,82408,19118,50108,32300,10506,386,-3062.0
47225,107234,74659,16440,50678,23981,5878,127,-1790.0
47073,89747,55024,10960,44288,10736,1171,5,1390.0
26258,42175,22493,3985,21076,1417,23,0,2591.0
48574,101876,66924,14069,49434,17490,3008,34,-447.0
41496,111087,87446,21251,47386,40060,16315,902,-3396.0
47995,92379,57052,11432,45512,11540,1355,11,1236.0
45079,109889,80581,18490,50222,30359,9445,295,-2719.0
48354,104670,70459,15115,50228,20231,4214,70,-972.0
47319,106841,74093,16265,50596,23497,5649,111,-1694.0
37520,109607,94096,24726,39836,54260,29935,3118,-2717.0
46819,87202,52519,10312,43166,9353,870,5,1824.0
46120,109023,78132,17605,50634,27498,7755,238,-2376.0
18312,28638,14905,2582,14318,587,2,0,1997.0
47476,89498,54399,10760,44238,10161,1022,4,1617.0
36476,108477,96372,26256,35208,61164,38061,5038,-1885.0
37236,109235,94910,25281,38134,56776,32967,3842,-2370.0
41543,111105,87384,21228,47400,39984,16305,955,-3406.0
39094,66729,37493,6951,33280,4213,169,0,2907.0
45913,109139,78379,17669,50744,27635,7651,201,-2516.0
9388,14340,7299,1238,7170,129,0,0,1109.0
48689,101461,66411,13930,49242,17169,2977,29,-291.0
46951,106796,74402,16384,50500,23902,5796,105,-1827.0
47286,88685,53673,10576,43890,9783,905,0,1698.0
46780,108470,76615,17056,50894,25721,6682,148,-2131.0
43293,110393,83546,19651,49186,34360,12021,517,-3205.0
47548,106793,73809,16163,50640,23169,5513,106,-1599.0
48375,100970,66118,13867,49034,17084,2902,29,-344.0
36210,107841,97287,27013,32496,64791,42849,6428,-1357.0
36540,108549,96308,26194,35452,60856,37645,4878,-1895.0
14724,22874,11832,2038,11436,396,2,0,1644.0
39267,110701,91378,23156,43820,47558,23061,1871,-3212.0
35690,106735,98887,28406,27338,71549,52059,9480,-564.0
48546,99092,63918,13257,48294,15624,2504,22,115.0
35456,59400,32862,6013,29646,3216,108,0,2905.0
37792,64428,36172,6703,32126,4046,176,0,2833.0
40670,70219,39826,7442,35000,4826,219,0,2835.0
47990,104337,70332,15090,50124,20208,4089,76,-1105.0
48126,105912,72048,15571,50670,21378,4572,74,-1309.0
47181,108003,75678,16755,50826,24852,6351,153,-1899.0
41570,111321,87652,21312,47432,40220,16457,960,-3411.0
27624,44454,23751,4215,22212,1539,30,0,2706.0
35885,104647,101143,31882,10994,90149,82659,23893,499.0
35625,105392,100292,30167,19582,80710,66228,15327,358.0
35932,104546,101327,32567,7252,94075,90042,28388,146.0
45540,83073,49247,9548,41206,8041,661,2,2166.0
47830,92831,57722,11633,45646,12076,1539,8,1088.0
34222,56731,31100,5645,28330,2770,71,0,2946.0
31672,51914,28183,5072,25934,2249,46,0,2869.0
37811,109859,93679,24458,40610,53069,28639,2855,-2827.0
43703,111150,84021,19752,49530,34491,12090,529,-3178.0
32394,53269,29004,5234,26604,2400,61,0,2895.0
26282,42171,22471,3978,21074,1397,23,0,2604.0
37635,109839,94254,24776,39852,54402,30135,3235,-2726.0
48365,95682,60333,12293,46908,13425,1866,11,723.0
37138,109230,95043,25320,38166,56877,32898,3710,-2369.0
42837,76091,44158,8411,37850,6308,391,1,2493.0
43571,110875,83974,19780,49268,34706,12339,523,-3110.0
38408,65614,36889,6842,32726,4163,162,0,2841.0
25822,41487,22128,3920,20736,1392,15,0,2543.0
48325,106269,72261,15614,50838,21423,4593,81,-1297.0
47598,91527,56477,11308,45106,11371,1315,12,1240.0
43894,110994,83565,19579,49656,33909,11682,466,-3114.0
42794,110709,84834,20171,48642,36192,13425,656,-3252.0
11512,17684,9050,1543,8842,208,0,0,1335.0
38910,110698,92192,23556,43048,49144,24602,2166,-3152.0
36841,109031,95461,25596,37346,58115,34339,4145,-2325.0
46773,107592,75601,16766,50606,24995,6380,135,-1984.0
41066,111374,88535,21686,46954,41581,17466,1030,-3459.0
44464,110781,82492,19161,50018,32474,10745,418,-2986.0
38397,110201,92610,23858,42072,50538,26057,2429,-3052.0
48847,103185,68195,14412,49918,18277,3349,39,-555.0
35869,104650,101154,31919,10794,90360,83062,24167,454.0
42338,74807,43249,8215,37208,6041,391,0,2565.0
35596,59740,33101,6065,29812,3289,116,0,2892.0
35932,104562,101318,32496,7660,93658,89242,27888,192.0
37127,109335,95029,25299,38264,56765,32807,3819,-2478.0
35669,105208,100433,30465,18076,82357,69056,16735,429.0
44247,110268,82088,19056,49840,32248,10588,385,-2989.0
48009,92451,57110,11444,45556,11554,1339,5,1224.0
35902,107447,98051,27592,30550,67501,46347,7524,-1086.0
41770,72925,41738,7859,36322,5416,281,0,2724.0
28038,45271,24254,4314,22624,1630,23,0,2707.0
48267,98775,63821,13252,48130,15691,2515,15,61.0
48836,101938,66790,14018,49472,17318,2994,24,-330.0
48722,99048,63701,13182,48310,15391,2428,26,193.0
44976,109938,80675,18512,50278,30397,9382,296,-2799.0
42119,110953,86223,20734,48042,38181,14869,767,-3345.0
48584,98629,63306,13072,48180,15126,2269,26,189.0
48819,100159,64863,13497,48744,16119,2671,23,26.0
38979,110454,91676,23349,43258,48418,23938,2017,-3148.0
42951,110769,84665,20087,48808,35857,13153,623,-3240.0
8400,12796,6496,1099,6398,98,0,0,1001.0
45191,109405,79897,18284,50090,29807,9225,303,-2601.0
46538,86777,52328,10287,42934,9394,909,0,1802.0
46896,88563,53913,10678,43758,10155,1047,2,1568.0
35687,105184,100545,30563,17712,82833,69760,17005,485.0
35686,105351,100331,30258,19114,81217,67123,15756,408.0
46991,107415,75015,16543,50772,24243,5871,123,-1952.0
47073,107696,75322,16635,50834,24488,6028,111,-1936.0
40250,69811,39749,7453,34780,4969,251,0,2735.0
35937,104544,101371,32740,6302,95069,91940,29587,24.0
47749,106268,72845,15836,50674,22171,4920,95,-1510.0
33406,55487,30474,5541,27702,2772,83,0,2852.0
47036,87727,52915,10406,43394,9521,939,6,1818.0
38807,110619,92202,23569,42990,49212,24639,2175,-3179.0
38989,110601,91746,23350,43392,48354,23817,2029,-3216.0
43612,110756,83518,19581,49550,33968,11656,476,-3207.0
35849,107525,97719,27324,31494,66225,44537,6917,-1281.0
46014,108846,77939,17535,50668,27271,7510,202,-2428.0
3712,5616,2832,476,2808,24,0,0,452.0
48628,98204,62884,12972,47936,14948,2332,20,336.0
18054,28341,14801,2572,14170,631,1,0,1942.0
48825,102410,67368,14189,49602,17766,3206,35,-406.0
46823,107314,75171,16629,50568,24603,6178,153,-1949.0
48651,98746,63448,13121,48170,15278,2406,17,232.0
48339,103729,69401,14819,49888,19513,3953,67,-808.0
47260,89426,54513,10808,44178,10335,1070,4,1539.0
15918,24711,12774,2199,12354,420,3,0,1782.0
46112,108637,77679,17469,50544,27135,7549,198,-2315.0
38107,110022,92975,24059,41596,51379,26830,2509,-2999.0
36623,108762,95975,25947,36268,59707,36226,4577,-2111.0
48617,104056,69415,14776,50174,19241,3708,43,-800.0
44485,110211,81768,18937,49914,31854,10383,361,-2895.0
36701,108816,95662,25755,36794,58868,35228,4323,-2208.0
40464,111108,89057,21949,46420,42637,18268,1116,-3536.0
35709,106914,98577,28115,28464,70113,49986,8731,-743.0
36919,109116,95552,25628,37336,58216,34444,4129,-2273.0
48165,94502,59189,11991,46432,12757,1638,11,861.0
36441,61345,34076,6257,30610,3466,125,1,2915.0
44172,110607,82617,19230,49854,32763,10899,414,-3048.0
48599,100077,64892,13503,48766,16126,2545,11,-89.0
45637,110045,80000,18225,50650,29350,8745,253,-2633.0
39466,110734,90748,22824,44552,46196,21630,1602,-3344.0
46788,107582,75562,16752,50612,24950,6358,144,-1984.0
35730,105319,100552,30504,18080,82472,69159,16732,459.0
42233,74011,42489,8021,36852,5637,307,1,2690.0
46816,87799,53178,10492,43404,9774,991,6,1703.0
48493,94681,59106,11945,46542,12564,1597,5,973.0
16524,25734,13342,2303,12866,476,2,0,1829.0
38258,110070,92799,23982,41706,51093,26658,2542,-2995.0
37754,109724,94046,24715,39802,54244,30120,3230,-2639.0
42020,111209,86795,20953,47872,38923,15465,842,-3347.0
39369,110730,91050,22976,44244,46806,22242,1699,-3287.0
40412,69818,39630,7412,34788,4842,242,0,2812.0
47747,93861,58890,11949,46086,12804,1689,7,827.0
35955,107702,97727,27286,31738,65989,44226,6829,-1306.0
41482,111167,87497,21259,47440,40057,16287,936,-3447.0
41564,111116,87536,21304,47248,40288,16620,956,-3320.0
43562,77325,44856,8542,38460,6396,405,0,2551.0
39387,110568,90832,22915,44174,46658,22220,1741,-3264.0
48014,93493,58249,11754,45974,12275,1545,8,1016.0
43204,111045,84655,20040,49070,35585,12905,586,-3226.0
37424,109798,94652,24976,39448,55204,30902,3372,-2698.0
40683,110990,88761,21864,46338,42423,18314,1165,-3410.0
13694,21157,10887,1866,10578,309,1,0,1558.0
47690,92066,56975,11433,45352,11623,1362,6,1166.0
47780,91151,55909,11140,44978,10931,1195,6,1398.0
35664,105931,99596,29342,23140,76456,59651,12550,-13.0
42700,75574,43742,8315,37594,6148,386,0,2553.0
29392,48014,25991,4666,23986,2005,42,0,2703.0
47386,107253,74535,16394,50706,23829,5841,132,-1726.0
39283,110704,91345,23137,43868,47477,22968,1841,-3213.0
19852,31218,16332,2843,15606,726,6,0,2123.0
43942,110857,83292,19486,49668,33624,11521,492,-3109.0
12722,19621,10080,1725,9810,270,1,0,1456.0
45396,109648,79889,18245,50308,29581,9032,304,-2608.0
33492,55682,30606,5569,27798,2808,86,0,2847.0
34340,57336,31625,5771,28624,3001,88,0,2858.0
46388,108566,77112,17232,50832,26280,6902,152,-2298.0
35770,107067,98611,28094,28658,69953,49751,8672,-780.0
48361,99387,64430,13416,48364,16066,2659,21,-12.0
35557,105542,100143,29939,20652,79491,64238,14467,219.0
42032,73776,42408,8014,36732,5676,312,0,2650.0
19668,30920,16173,2815,15456,717,8,0,2106.0
48776,102131,67064,14101,49522,17542,3087,38,-392.0
42785,110975,85135,20249,48776,36359,13423,617,-3304.0
33864,56394,31043,5656,28150,2893,94,0,2857.0
46272,109155,78054,17545,50838,27216,7479,182,-2374.0
36922,62359,34733,6392,31114,3619,131,0,2904.0
40290,111073,89763,22324,45582,44181,19909,1396,-3344.0
35506,59609,33038,6055,29746,3292,117,0,2880.0
40934,111094,88611,21795,46452,42159,18190,1170,-3344.0
43729,111025,83648,19590,49756,33892,11513,449,-3238.0
48237,102633,68218,14486,49520,18698,3593,45,-664.0
27346,43977,23474,4161,21982,1492,13,0,2682.0
39269,110485,91189,23127,43616,47573,23253,1961,-3154.0
42072,111221,86632,20870,48044,38588,15133,802,-3387.0
28318,45873,24655,4399,22916,1739,41,0,2701.0
36908,109054,95562,25681,37038,58524,34978,4400,-2265.0
35651,106280,99390,28977,24918,74472,56444,11165,-216.0
44316,79686,46712,8974,39580,7132,526,0,2368.0
37836,110084,94002,24580,40524,53478,29036,2964,-2826.0
42944,110811,84846,20169,48678,36168,13455,646,-3190.0
42012,111109,86693,20928,47818,38875,15473,858,-3332.0
40745,110777,88114,21587,46706,41408,17365,1049,-3505.0
38298,65471,36841,6840,32642,4199,187,0,2828.0
48446,99545,64530,13438,48432,16098,2681,28,-7.0
48166,99204,64354,13400,48308,16046,2588,26,-84.0
41402,72321,41430,7810,36000,5430,321,0,2701.0
47553,106199,73146,15981,50406,22740,5387,109,-1481.0
35934,104547,101294,32436,7972,93322,88603,27472,245.0
48780,101347,66231,13880,49182,17049,2983,30,-216.0
48347,104174,69820,14915,50150,19670,3874,41,-922.0
47932,92623,57378,11527,45594,11784,1435,18,1160.0
44185,79192,46283,8867,39364,6919,464,3,2409.0
48361,99940,65053,13591,48560,16493,2820,35,-117.0
47815,91802,56601,11328,45234,11367,1334,9,1286.0
5672,8604,4350,733,4302,48,0,0,685.0
37344,109401,94432,24951,39158,55274,31085,3338,-2576.0
24682,39411,20905,3685,19700,1205,11,0,2491.0
46559,86912,52451,10318,42994,9457,924,5,1780.0
35764,104888,100864,31169,14714,86150,75460,19908,571.0
21388,33776,17737,3098,16886,851,4,0,2251.0
48430,103563,69017,14678,49966,19051,3631,52,-794.0
45758,108946,78511,17767,50420,28091,8106,226,-2444.0
42291,110668,85386,20393,48414,36972,13840,645,-3384.0
46661,106602,74414,16405,50398,24016,5806,127,-1932.0
38875,110338,91661,23351,43216,48445,23906,1965,-3153.0
36792,108982,95666,25716,37036,58630,34910,4236,-2240.0
46589,108280,76759,17152,50606,26153,7068,151,-2084.0
38250,65119,36505,6754,32486,4019,147,0,2882.0
32994,54513,29806,5399,27218,2588,77,0,2888.0
48197,103951,69727,14907,50012,19715,3927,53,-934.0
46411,108328,76877,17179,50680,26197,6968,169,-2219.0
43984,110280,82558,19262,49544,33014,11192,440,-3000.0
47759,105507,72059,15633,50320,21739,4867,83,-1322.0
45294,83127,49506,9633,41214,8292,699,0,2040.0
33960,56700,31276,5708,28304,2972,92,0,2828.0
35821,104739,101005,31568,12602,88403,79535,22181,519.0
39033,110529,91440,23206,43644,47796,23241,1913,-3262.0
46188,108321,77169,17299,50544,26625,7233,170,-2263.0
9248,14104,7168,1214,7052,116,0,0,1098.0
21228,33444,17525,3055,16720,805,4,0,2254.0
15184,23600,12212,2104,11800,412,0,0,1692.0
35705,106533,99017,28612,26362,72655,53809,10189,-423.0
43796,110782,83365,19518,49622,33743,11538,452,-3139.0
31850,52547,28691,5190,26242,2449,63,0,2804.0
46796,88871,54351,10808,43854,10497,1163,6,1468.0
45595,110002,79857,18159,50760,29097,8482,253,-2709.0
48230,96003,60790,12425,47030,13760,1943,16,592.0
43515,110849,83846,19708,49444,34402,11961,463,-3196.0
47507,89564,54431,10763,44284,10147,996,1,1611.0
47551,104429,71005,15348,49922,21083,4585,71,-1221.0
44312,110407,82126,19043,49994,32132,10419,342,-3012.0
35685,105604,100083,29914,20682,79401,64240,14503,250.0
48444,98352,63162,13051,48018,15144,2316,20,203.0
18402,28765,14964,2591,14382,582,1,0,2010.0
43009,77183,45185,8673,38332,6853,519,1,2338.0
42748,75456,43575,8267,37548,6027,360,0,2600.0
42487,75748,44116,8432,37640,6476,468,1,2423.0
38764,65994,37000,6847,32918,4082,158,0,2923.0
45033,109970,80508,18429,50442,30066,9086,307,-2858.0
44016,79453,46738,9008,39428,7310,597,2,2293.0
40698,70195,39785,7431,34984,4801,227,0,2857.0
46432,86559,52195,10262,42818,9377,923,2,1806.0
47655,91787,56709,11365,45228,11481,1331,3,1212.0
46704,107987,76065,16889,50796,25269,6395,122,-2107.0
47460,91822,56964,11460,45168,11796,1486,8,1142.0
37272,109602,94298,24790,39856,54442,29890,3060,-2822.0
45761,108819,78274,17681,50462,27812,7895,229,-2465.0
45668,109676,79487,18067,50572,28915,8532,272,-2588.0
12240,18796,9616,1639,9398,218,0,0,1421.0
48127,106014,72237,15640,50634,21603,4746,73,-1290.0
35921,104564,101289,32366,8382,92907,87800,26979,280.0
45789,109630,79215,17951,50724,28491,8182,219,-2577.0
48990,98242,62555,12843,48052,14503,2138,18,460.0
44248,110071,81826,18971,49826,32000,10419,358,-2968.0
35694,106213,99458,29100,24316,75142,57581,11700,-161.0
48060,93077,57754,11616,45812,11942,1453,6,1121.0
40802,111211,88781,21831,46576,42205,18059,1144,-3459.0
35739,104851,100887,31193,14616,86271,75619,19959,582.0
30392,49890,27125,4889,24916,2209,58,0,2738.0
48056,94888,59766,12169,46518,13248,1852,8,765.0
40310,110913,89346,22146,45816,43530,19281,1300,-3403.0
7360,11228,5708,967,5614,94,0,0,873.0
41531,111088,87486,21281,47286,40200,16516,949,-3352.0
48352,100012,65130,13609,48606,16524,2800,24,-139.0
45089,109464,80086,18354,50048,30038,9368,327,-2643.0
36463,108559,96148,26100,35696,60452,37167,4863,-2048.0
47462,105792,72664,15827,50366,22298,5060,82,-1493.0
38539,110403,92327,23652,42742,49585,24919,2175,-3189.0
44842,109991,80950,18624,50156,30794,9679,332,-2823.0
48876,102595,67572,14252,49632,17940,3331,42,-399.0
45184,109854,80324,18385,50338,29986,9178,308,-2731.0
43038,76805,44739,8548,38190,6549,425,0,2424.0
35650,105322,100345,30300,18890,81455,67542,16014,373.0
44503,80912,47834,9252,40156,7678,600,1,2173.0
41003,110982,88102,21560,46844,41258,17294,1033,-3437.0
39394,110831,91359,23135,43908,47451,23015,1912,-3213.0
36292,108370,96479,26335,34948,61531,38474,5212,-1934.0
10240,15704,8024,1366,7852,172,0,0,1194.0
45446,109785,79883,18211,50500,29383,8785,280,-2667.0
23714,37735,19957,3509,18860,1097,15,0,2427.0
2112,3184,1600,268,1592,8,0,0,260.0
