N0,N1,N2,Volume,Enclosing_surface,Contact_surface,TETRAVOXEL,OCTOVOXEL,MISC_Async
35924,107542,97833,27407,31224,66609,45094,7084,-1192.0
35603,106421,99128,28732,25864,73264,54693,10583,-422.0
46842,108716,76900,17145,50930,25970,6856,150,-2119.0
47974,92962,57668,11591,45790,11878,1382,6,1089.0
48826,96680,60968,12419,47422,13546,1836,14,695.0
35924,104548,101312,32487,7702,93610,89144,27820,201.0
36819,109072,95837,25811,36808,59029,35456,4465,-2227.0
38857,110493,91773,23367,43344,48429,23805,1973,-3230.0
47308,106815,74060,16254,50596,23464,5623,114,-1701.0
47722,104845,71280,15403,50142,21138,4561,72,-1246.0
43745,110704,83483,19597,49384,34099,11936,507,-3073.0
36514,61535,34205,6283,30712,3493,111,0,2901.0
38542,110385,92207,23589,42880,49327,24625,2112,-3225.0
43764,110324,82683,19277,49704,32979,10916,368,-3154.0
38006,110022,93418,24297,41054,52364,27914,2742,-2895.0
48923,102838,67759,14289,49784,17975,3270,29,-445.0
36341,108252,97113,26786,33510,63603,41232,5999,-1584.0
40409,111402,89860,22297,45938,43922,19526,1331,-3430.0
44131,110613,82718,19273,49798,32920,11017,407,-3037.0
40838,70703,40204,7531,35222,4982,259,0,2808.0
46864,107203,75015,16581,50544,24471,6115,130,-1905.0
47865,104091,70194,15064,50004,20190,4083,53,-1096.0
47168,107519,74993,16528,50818,24175,5883,122,-1886.0
44976,110111,81023,18650,50146,30877,9819,354,-2762.0
46921,88315,53595,10584,43686,9909,943,1,1617.0
35908,104565,101273,32337,8524,92749,87517,26826,279.0
42983,111158,85035,20176,49014,36021,13130,601,-3316.0
40334,70013,39885,7481,34884,5001,245,0,2725.0
42648,74988,43171,8170,37322,5849,344,4,2661.0
48544,98786,63553,13150,48206,15347,2374,16,161.0
42705,110689,84989,20240,48538,36451,13613,637,-3235.0
46761,107585,75578,16753,50638,24940,6309,121,-1999.0
40918,110925,88199,21622,46666,41533,17593,1112,-3430.0
14420,22290,11476,1968,11144,332,2,0,1638.0
33568,55624,30482,5531,27778,2704,68,0,2895.0
48112,95123,59918,12193,46678,13240,1767,6,714.0
35804,107076,98368,27928,29168,69200,48740,8300,-832.0
48435,102254,67586,14290,49432,18154,3390,49,-523.0
44156,110230,82084,19051,49862,32222,10506,376,-3041.0
45094,110360,81152,18659,50350,30802,9660,290,-2773.0
39409,110839,91193,23029,44212,46981,22415,1729,-3266.0
32826,54079,29485,5326,27014,2471,51,0,2906.0
36688,61936,34488,6346,30900,3588,136,0,2894.0
8556,13060,6643,1126,6530,113,0,0,1013.0
27602,44617,23932,4262,22292,1640,33,0,2655.0
35596,106665,98835,28368,27462,71373,51741,9338,-602.0
48272,103679,69315,14778,49962,19353,3755,50,-870.0
48600,102470,67674,14300,49548,18126,3374,44,-496.0
46059,86058,51974,10230,42568,9406,922,1,1745.0
25398,40755,21714,3843,20370,1344,15,0,2514.0
44820,110497,81593,18819,50272,31321,9953,354,-2903.0
21208,33512,17610,3078,16752,858,8,0,2228.0
40673,111089,89044,21988,46160,42884,18769,1233,-3360.0
46761,107767,75815,16830,50650,25165,6467,153,-2021.0
11048,16916,8630,1467,8458,172,0,0,1295.0
35937,104544,101357,32682,6622,94735,91300,29179,68.0
37782,109991,93643,24392,40934,52709,28123,2764,-2958.0
47589,106313,73138,15953,50558,22580,5197,109,-1539.0
47715,91403,56226,11227,45090,11136,1223,3,1311.0
44252,110025,81784,18961,49802,31982,10421,350,-2950.0
35762,105018,100693,30885,16076,84617,72866,18582,552.0
42756,111445,85894,20517,48686,37208,14073,694,-3312.0
48384,103705,69318,14787,49914,19404,3877,50,-790.0
35838,107310,98284,27799,29774,68510,47762,8038,-987.0
37576,109760,94542,24958,39336,55206,31088,3440,-2600.0
43974,110705,83128,19446,49580,33548,11545,492,-3049.0
35200,59026,32679,5983,29460,3219,106,0,2870.0
47973,104529,70679,15211,50092,20587,4345,57,-1088.0
39351,110825,90991,22905,44552,46439,21721,1575,-3388.0
36314,60957,33780,6190,30420,3360,117,0,2947.0
35684,59806,33096,6057,29850,3246,106,0,2917.0
46327,109321,78301,17636,50786,27515,7749,199,-2329.0
42331,111245,86368,20755,48206,38162,14833,727,-3301.0
21546,34053,17898,3129,17022,876,9,0,2262.0
44808,81210,47853,9225,40356,7497,498,0,2226.0
38657,110544,92090,23495,43210,48880,24124,2031,-3292.0
46334,108242,76943,17228,50518,26425,7206,202,-2193.0
47568,106517,73355,16004,50686,22669,5145,78,-1598.0
43088,76871,44765,8551,38224,6541,423,2,2431.0
35851,107456,97683,27332,31374,66309,44708,6985,-1254.0
38148,110233,93357,24215,41424,51933,27385,2610,-2943.0
43450,111049,84160,19812,49448,34712,12153,504,-3251.0
45308,83339,49724,9691,41302,8422,735,2,2002.0
46736,88841,54365,10815,43840,10525,1161,6,1445.0
48667,99849,64647,13448,48606,16041,2637,27,17.0
48603,98345,62986,12984,48068,14918,2209,15,260.0
43740,110179,82758,19358,49368,33390,11443,450,-3039.0
37941,109993,93630,24416,40764,52866,28465,2853,-2838.0
46334,108601,77318,17322,50704,26614,7193,172,-2271.0
37404,109547,94676,25060,38992,55684,31563,3466,-2527.0
34576,57684,31806,5804,28788,3018,108,0,2894.0
37944,109890,93497,24383,40696,52801,28498,2912,-2832.0
23666,37589,19844,3483,18790,1054,9,0,2438.0
25818,41361,22006,3890,20672,1334,17,0,2573.0
1348,2028,1017,170,1014,3,0,0,167.0
14560,22504,11584,1986,11252,332,0,0,1654.0
46509,107896,76320,17021,50514,25806,6868,171,-2088.0
47519,91335,56329,11271,45032,11297,1271,3,1242.0
35870,104734,101075,31688,12022,89053,80690,22802,523.0
48430,103668,69201,14743,49944,19257,3780,46,-780.0
45693,109314,78988,17911,50510,28478,8294,271,-2544.0
37798,109871,93616,24426,40676,52940,28519,2888,-2883.0
24916,39886,21206,3746,19936,1270,14,0,2490.0
42602,111361,86014,20583,48530,37484,14301,728,-3328.0
46379,85790,51416,10058,42484,8932,822,1,1947.0
48241,94963,59623,12102,46634,12989,1695,9,799.0
49125,98997,63228,13009,48402,14826,2193,29,347.0
37516,109632,94334,24858,39520,54814,30592,3276,-2640.0
47289,106478,73629,16117,50556,23073,5366,87,-1677.0
47077,106096,73460,16102,50308,23152,5480,91,-1661.0
25312,40474,21501,3796,20226,1275,22,0,2543.0
47936,94444,59360,12062,46348,13012,1748,8,790.0
36017,107608,97683,27313,31488,66195,44632,6971,-1221.0
40136,69068,39068,7284,34432,4636,204,0,2852.0
47333,107714,75132,16569,50850,24282,6014,119,-1818.0
47775,93050,57960,11690,45780,12180,1490,5,995.0
40144,110950,89681,22290,45622,44059,19706,1352,-3415.0
28516,46320,24949,4459,23144,1805,32,0,2686.0
46520,108919,77403,17309,50952,26451,7015,178,-2305.0
44006,79554,46821,9023,39504,7317,546,2,2250.0
46697,107710,75875,16868,50542,25333,6626,167,-2006.0
48265,103659,69313,14782,49934,19379,3791,57,-863.0
46428,108791,77447,17351,50788,26659,7215,174,-2267.0
45921,109198,78578,17757,50614,27964,7970,219,-2456.0
35879,107420,98071,27617,30440,67631,46540,7613,-1087.0
36203,108042,97221,26893,33084,64137,41874,6141,-1511.0
35666,105903,99812,29513,22546,77266,60811,12996,62.0
44298,79145,46162,8832,39332,6830,481,0,2483.0
48687,102867,68043,14395,49716,18327,3435,35,-532.0
48156,99367,64603,13483,48308,16295,2751,30,-91.0
36408,108272,96754,26558,34160,62594,39952,5584,-1668.0
39431,110921,91272,23055,44214,47058,22493,1763,-3273.0
42581,110863,85164,20269,48714,36450,13435,641,-3387.0
48647,101335,66359,13931,49132,17227,3071,35,-260.0
20022,31411,16396,2848,15704,692,3,0,2159.0
37898,110051,93544,24334,41084,52460,27883,2700,-2943.0
37436,63364,35357,6517,31612,3745,140,0,2912.0
35933,107524,97745,27376,31234,66511,45056,7143,-1222.0
38828,110482,92088,23537,42954,49134,24574,2080,-3103.0
46023,108866,77986,17551,50666,27320,7534,173,-2408.0
368,552,276,46,276,0,0,0,46.0
37601,109723,94085,24698,39982,54103,29759,3089,-2735.0
19556,30594,15928,2760,15296,632,2,0,2130.0
45097,109552,79999,18284,50294,29705,8964,283,-2740.0
35604,106264,99467,29020,24814,74653,56636,11216,-213.0
39619,110622,90484,22738,44540,45944,21542,1593,-3257.0
45544,109397,79218,17984,50532,28686,8333,250,-2619.0
40828,71298,40812,7685,35514,5298,270,0,2657.0
44415,79814,46739,8968,39670,7069,474,1,2372.0
46528,87211,52773,10400,43146,9627,919,2,1690.0
38520,110507,92770,23869,42326,50444,25855,2366,-3086.0
42114,74037,42628,8069,36842,5786,353,0,2636.0
35856,106980,98359,27975,28868,69491,49244,8468,-740.0
37887,110049,93568,24358,40988,52580,28073,2803,-2952.0
48212,104300,70059,14987,50196,19863,3908,48,-1016.0
48818,100131,64778,13461,48790,15988,2551,20,4.0
42267,111207,86289,20721,48252,38037,14703,759,-3372.0
47672,106860,73637,16074,50830,22807,5200,92,-1625.0
48939,101449,66147,13832,49302,16845,2845,27,-195.0
35877,107337,98021,27613,30364,67657,46609,7617,-1052.0
35871,104682,101136,31788,11544,89592,81594,23253,537.0
40708,111073,88844,21886,46372,42472,18329,1150,-3407.0
41536,72890,41881,7910,36302,5579,286,0,2617.0
35692,59784,33071,6051,29836,3235,112,0,2928.0
47826,104689,71003,15316,50110,20893,4469,68,-1176.0
47729,106093,72645,15775,50640,22005,4813,77,-1494.0
35588,59814,33170,6080,29860,3310,94,0,2864.0
38024,110039,93411,24293,41064,52347,27911,2754,-2897.0
35723,106614,99007,28559,26660,72347,53294,9949,-443.0
14216,21990,11329,1944,10994,335,2,0,1611.0
37465,109677,94263,24789,39792,54471,30093,3149,-2738.0
35599,105633,100021,29778,21374,78647,62885,13807,209.0
48129,105550,71677,15477,50492,21185,4566,79,-1221.0
38354,110358,92946,23991,41946,51000,26466,2506,-3049.0
46781,108288,76415,17000,50830,25585,6628,135,-2092.0
37168,63114,35307,6521,31488,3819,138,0,2840.0
35937,107532,97785,27404,31146,66639,45240,7219,-1214.0
37000,62574,34891,6427,31220,3671,134,0,2890.0
44786,110552,81643,18824,50342,31301,9868,338,-2947.0
48876,98135,62570,12863,47962,14608,2211,18,448.0
48407,100968,66169,13898,48950,17219,3068,37,-290.0
35719,105098,100687,30816,16478,84209,72142,18257,492.0
34548,57484,31617,5756,28698,2919,88,0,2925.0
48747,100567,65325,13619,48936,16389,2695,39,-114.0
41699,111350,87562,21278,47456,40106,16438,977,-3367.0
35932,104546,101344,32638,6860,94484,90826,28888,92.0
43739,110715,83413,19558,49478,33935,11759,503,-3121.0
47959,95105,60033,12236,46650,13383,1805,7,651.0
48501,97036,61690,12650,47480,14210,2076,11,505.0
2468,3732,1881,316,1866,15,0,0,301.0
48171,105251,71266,15350,50432,20834,4387,67,-1164.0
47845,105574,71988,15591,50430,21558,4714,79,-1332.0
46201,109031,78025,17554,50726,27299,7579,193,-2359.0
47708,105894,72547,15775,50444,22103,5006,92,-1414.0
8376,12784,6502,1102,6392,110,0,0,992.0
35803,104851,100859,31243,14260,86599,76331,20407,568.0
38464,110442,92878,23930,42176,50702,26090,2348,-3030.0
45630,109143,78729,17811,50592,28137,7959,228,-2595.0
48194,103081,68728,14623,49718,19010,3645,40,-782.0
45459,83030,49280,9565,41170,8110,690,1,2144.0
45969,84894,50812,9929,42050,8762,794,3,1958.0
48462,95878,60462,12321,46998,13464,1882,14,725.0
33408,55478,30465,5539,27696,2769,86,0,2856.0
45209,109964,80425,18411,50384,30041,9196,307,-2741.0
37815,110046,93796,24475,40742,53054,28562,2893,-2910.0
47899,107553,74228,16224,51112,23116,5329,87,-1650.0
45002,81527,48063,9275,40476,7587,575,0,2263.0
43948,78670,45948,8800,39096,6852,478,0,2426.0
47826,92727,57574,11584,45644,11930,1439,4,1089.0
40000,68952,39064,7294,34364,4700,224,0,2818.0
42441,111229,85935,20549,48576,37359,14077,669,-3402.0
44674,111066,82565,19150,50230,32335,10606,398,-2977.0
48106,105341,71493,15434,50382,21111,4577,76,-1176.0
43307,77798,45582,8755,38634,6948,530,1,2336.0
48762,96964,61375,12544,47486,13889,1992,18,629.0
48031,93292,57982,11673,45926,12056,1440,9,1048.0
18884,29662,15500,2695,14830,670,2,0,2027.0
35534,105913,99737,29391,23128,76609,59657,12472,-33.0
46736,108227,76461,17037,50700,25761,6827,170,-2067.0
36363,108261,96746,26564,34108,62638,40045,5687,-1716.0
48317,97898,62770,12952,47828,14942,2242,15,237.0
37973,110237,93708,24369,41202,52506,27833,2621,-2925.0
46264,108810,77733,17473,50628,27105,7554,208,-2286.0
35880,107397,98037,27596,30498,67539,46401,7534,-1076.0
120,180,90,15,90,0,0,0,15.0
35681,105594,100128,29960,20496,79632,64602,14675,255.0
40529,111126,89296,22101,45986,43310,19154,1347,-3402.0
37947,110089,93242,24158,41536,51706,27017,2527,-3058.0
48596,102039,67183,14161,49400,17783,3239,38,-421.0
47730,105517,72020,15606,50404,21616,4709,72,-1373.0
45666,109949,79838,18170,50656,29182,8637,240,-2615.0
35690,106406,99270,28845,25470,73800,55466,10802,-291.0
48321,96063,60779,12415,47068,13711,1927,9,622.0
44659,110069,81244,18726,50132,31112,9805,311,-2892.0
48540,97084,61700,12649,47506,14194,2072,20,507.0
49110,101514,66119,13824,49294,16825,2926,34,-109.0
46048,108681,77728,17474,50612,27116,7457,194,-2379.0
48337,102082,67453,14252,49394,18059,3294,31,-544.0
45103,81794,48269,9324,40594,7675,606,1,2254.0
35668,105225,100569,30556,17802,82767,69621,16954,456.0
47103,107115,74655,16451,50604,24051,5907,115,-1808.0
36307,108461,96781,26475,34712,62069,39037,5291,-1848.0
44694,109976,81250,18762,49928,31322,10120,354,-2794.0
48684,104001,69295,14738,50162,19133,3677,42,-760.0
43353,76773,44452,8452,38192,6260,389,1,2580.0
40222,111150,89806,22309,45758,44048,19634,1326,-3431.0
48961,101689,66411,13906,49386,17025,2917,21,-223.0
48248,93821,58350,11752,46188,12162,1445,10,1025.0
43712,78378,45843,8791,38940,6903,498,0,2386.0
39110,110657,91625,23286,43534,48091,23589,1992,-3208.0
48015,102459,68207,14496,49438,18769,3583,43,-733.0
35768,104842,100841,31205,14452,86389,75938,20192,562.0
37556,109663,94185,24767,39768,54417,30127,3166,-2689.0
33646,55737,30543,5543,27828,2715,81,0,2909.0
48319,95468,60137,12243,46816,13321,1836,13,745.0
41969,73919,42633,8083,36768,5865,383,1,2600.0
38602,110407,92276,23640,42712,49564,24983,2228,-3169.0
44143,78774,45905,8777,39148,6757,478,1,2497.0
42000,74126,42825,8131,36864,5961,398,0,2568.0
30924,50824,27653,4986,25390,2263,44,0,2767.0
39254,110530,91002,22992,44052,46950,22426,1734,-3266.0
38975,110679,91877,23385,43444,48433,23791,1955,-3212.0
39483,110482,90745,22924,43946,46799,22590,1893,-3178.0
45903,84223,50173,9769,41732,8441,759,3,2084.0
45804,109707,79362,18011,50658,28704,8391,250,-2552.0
33534,55289,30169,5454,27614,2555,61,0,2960.0
48386,102930,68401,14522,49670,18731,3590,46,-665.0
47574,91577,56542,11324,45140,11402,1297,4,1215.0
27936,45188,24246,4318,22584,1662,20,0,2676.0
36646,108855,95745,25782,36798,58947,35259,4340,-2246.0
19326,30443,15950,2780,15220,730,3,0,2053.0
48399,106093,72001,15535,50792,21209,4509,63,-1228.0
36536,108700,96114,26028,36060,60054,36580,4632,-2078.0
46356,108519,77128,17251,50750,26378,7019,178,-2286.0
45365,109875,80152,18314,50420,29732,9035,289,-2672.0
48826,99419,64035,13269,48456,15579,2507,24,173.0
48310,100877,66088,13867,48974,17114,2929,28,-346.0
47035,107105,74592,16414,50700,23892,5705,119,-1892.0
34356,57176,31455,5728,28542,2913,92,0,2907.0
25518,41003,21874,3876,20492,1382,19,0,2513.0
35496,59298,32729,5977,29596,3133,106,0,2950.0
35808,106948,98609,28152,28306,70303,50336,8868,-683.0
48025,94169,58990,11957,46238,12752,1693,9,889.0
40418,69933,39742,7440,34844,4898,245,0,2787.0
42609,110948,85380,20361,48594,36786,13760,655,-3320.0
48210,104037,69890,14969,49966,19924,4105,56,-906.0
35915,104580,101257,32219,9200,92057,86180,25969,373.0
37721,109913,94040,24626,40324,53716,29265,2953,-2778.0
36403,108391,96457,26331,34928,61529,38535,5199,-1862.0
45202,82735,49175,9554,41026,8149,683,0,2088.0
35874,104660,101096,31810,11332,89764,81996,23542,500.0
5328,8056,4060,682,4028,32,0,0,650.0
33512,55538,30439,5524,27734,2705,70,0,2889.0
47955,93210,57982,11684,45860,12122,1490,9,1043.0
48068,94285,59006,11941,46366,12640,1553,6,848.0
47038,88863,54111,10720,43902,10209,1059,4,1566.0
42295,111025,86113,20680,48146,37967,14733,743,-3297.0
38293,110415,93375,24200,41550,51825,27315,2637,-2947.0
44382,110187,81807,18955,49884,31923,10419,404,-2953.0
36665,108708,96220,26133,35642,60578,37424,4935,-1956.0
48661,99688,64451,13388,48574,15877,2540,15,36.0
46059,85235,51086,9992,42220,8866,795,3,1918.0
38530,110498,92670,23816,42444,50226,25610,2314,-3114.0
15862,24541,12645,2170,12270,375,1,0,1796.0
37006,109189,95063,25332,38134,56929,32921,3776,-2452.0
33644,55950,30756,5596,27936,2820,78,0,2854.0
48323,103699,69345,14795,49920,19425,3859,55,-826.0
37051,109270,95036,25289,38338,56698,32594,3657,-2472.0
43977,79209,46484,8937,39346,7138,517,1,2315.0
48475,102218,67492,14257,49442,18050,3334,49,-508.0
46618,108797,77302,17304,50780,26522,7237,200,-2181.0
35803,106985,98524,28084,28544,69980,49897,8743,-742.0
37013,109178,95271,25462,37770,57501,33638,3955,-2356.0
45586,109735,79632,18111,50598,29034,8539,244,-2628.0
30668,50050,27072,4857,25002,2070,46,0,2833.0
46836,108331,76326,16951,50946,25380,6439,130,-2120.0
40633,70041,39696,7417,34890,4806,261,1,2871.0
3820,5780,2915,490,2890,25,0,0,465.0
48677,104121,69505,14814,50126,19379,3869,57,-753.0
42829,111261,85405,20322,48878,36527,13505,649,-3349.0
48498,101464,66618,14009,49182,17436,3100,30,-357.0
44660,80746,47556,9174,40068,7488,610,0,2296.0
48604,102240,67405,14222,49478,17927,3284,32,-453.0
40255,110795,89342,22167,45682,43660,19431,1303,-3365.0
46832,108136,76087,16882,50882,25205,6372,148,-2099.0
35637,105657,100050,29843,21042,79008,63573,14221,187.0
47332,105805,72842,15898,50296,22546,5213,94,-1529.0
47019,108297,76081,16860,51002,25079,6293,131,-2057.0
38514,65621,36822,6820,32724,4098,173,0,2895.0
20984,33116,17382,3035,16554,828,8,0,2215.0
44683,80742,47512,9156,40088,7424,566,1,2297.0
46977,106964,74608,16450,50516,24092,5932,119,-1829.0
41338,71951,41077,7718,35846,5231,259,0,2746.0
36698,108849,95631,25718,36954,58677,34941,4220,-2238.0
46326,86356,52038,10221,42750,9288,856,2,1787.0
39167,110644,91217,23051,44128,47089,22388,1661,-3311.0
48722,97851,62388,12824,47832,14556,2187,20,435.0
48439,96901,61598,12630,47416,14182,2069,11,506.0
37992,109833,92992,24116,41288,51704,27257,2634,-2965.0
48918,102120,66966,14071,49506,17460,3108,26,-307.0
40597,110987,88981,21976,46106,42875,18775,1261,-3385.0
37115,109297,94983,25264,38382,56601,32533,3659,-2463.0
35936,104548,101335,32587,7148,94187,90252,28516,136.0
39286,110715,91273,23086,44030,47243,22655,1740,-3242.0
40134,110877,89724,22340,45408,44316,20061,1444,-3359.0
44200,111041,83071,19350,50042,33029,10957,398,-3120.0
46506,109055,77678,17413,50878,26800,7299,196,-2284.0
48069,103987,69895,14967,49988,19907,4011,61,-990.0
43549,78159,45758,8783,38818,6940,523,1,2365.0
43834,110769,83252,19467,49702,33550,11365,432,-3150.0
39539,110970,90987,22907,44532,46455,21906,1709,-3351.0
35990,107678,97685,27282,31678,66007,44322,6882,-1285.0
37154,109335,94864,25195,38558,56306,32219,3620,-2512.0
35624,106251,99200,28845,25330,73870,55591,10838,-272.0
38650,110533,92352,23646,42828,49524,24877,2176,-3177.0
47490,90863,55862,11152,44812,11050,1239,4,1337.0
604,908,455,76,454,1,0,0,75.0
43547,110626,83487,19594,49410,34077,11806,509,-3186.0
43185,111220,84809,20067,49216,35593,12788,555,-3293.0
47533,106478,73432,16051,50558,22874,5362,103,-1564.0
11546,17733,9074,1547,8866,208,1,0,1340.0
43106,110586,84146,19884,48988,35158,12610,554,-3218.0
46350,109169,78047,17551,50788,27259,7593,208,-2323.0
44910,81379,47987,9263,40396,7591,587,4,2255.0
43488,111300,84386,19867,49570,34816,12160,504,-3293.0
37650,63839,35661,6577,31860,3801,119,0,2895.0
19122,29977,15640,2716,14984,656,9,0,2069.0
48386,94005,58457,11777,46252,12205,1501,12,1061.0
48516,101954,67072,14115,49454,17618,3046,24,-481.0
46499,87545,53173,10513,43268,9905,1009,3,1614.0
37179,109372,94893,25217,38484,56409,32404,3729,-2517.0
47507,106989,73978,16193,50798,23180,5393,103,-1697.0
44510,110307,81774,18919,50034,31740,10239,360,-2942.0
42755,111011,85256,20301,48706,36550,13599,651,-3301.0
35643,106123,99609,29215,23928,75681,58267,11887,-86.0
37076,62682,34948,6438,31268,3680,146,0,2904.0
47272,106965,74214,16288,50700,23514,5565,106,-1767.0
38402,110128,92643,23897,41904,50739,26320,2458,-2980.0
47937,105594,72000,15604,50376,21624,4842,83,-1261.0
46756,107645,75648,16779,50622,25026,6401,174,-2020.0
41130,71763,41051,7726,35746,5305,271,0,2692.0
38365,110240,92709,23890,42078,50631,26084,2399,-3056.0
35906,104568,101264,32268,8920,92344,86728,26318,334.0
43034,110810,84549,20020,48978,35571,12854,550,-3247.0
12680,19524,10014,1711,9762,252,0,0,1459.0
39929,110758,89614,22270,45608,44006,19542,1291,-3485.0
38663,110668,92630,23772,42628,50002,25412,2329,-3147.0
43705,110890,83698,19657,49454,34244,11982,539,-3144.0
44010,110620,82937,19375,49624,33313,11372,482,-3048.0
36982,62285,34609,6356,31082,3527,121,0,2950.0
48416,104859,70601,15145,50332,20269,4195,58,-987.0
39705,110653,90226,22615,44762,45464,21129,1617,-3337.0
40328,69770,39653,7425,34756,4897,258,0,2786.0
47710,106811,73643,16098,50698,22945,5415,124,-1556.0
26872,43180,23036,4082,21580,1456,20,0,2646.0
38295,110247,92887,23976,41918,50969,26411,2459,-3041.0
46517,108812,77265,17266,50934,26331,6944,175,-2296.0
48911,100843,65529,13671,49032,16497,2779,27,-74.0
48682,101399,66376,13926,49196,17180,3007,20,-267.0
42224,111061,86072,20636,48328,37744,14405,698,-3401.0
35578,105545,100210,29998,20432,79778,64681,14656,245.0
32382,53169,28909,5210,26558,2351,53,0,2912.0
40388,111054,89246,22059,46138,43108,18778,1208,-3479.0
35834,107395,98011,27559,30668,67343,46059,7384,-1109.0
40768,71162,40741,7676,35426,5315,310,0,2671.0
39467,110439,90641,22860,44122,46519,22195,1727,-3191.0
35893,107342,98081,27642,30310,67771,46722,7603,-1010.0
43205,110680,84122,19867,49042,35080,12596,603,-3220.0
47626,91575,56519,11320,45118,11401,1339,8,1250.0
23574,37383,19708,3455,18686,1022,11,0,2444.0
45827,109055,78462,17723,50586,27876,7883,219,-2489.0
42948,111102,85204,20276,48752,36452,13598,648,-3226.0
47107,107131,74596,16417,50690,23906,5751,107,-1845.0
48193,93554,58145,11709,46036,12109,1482,7,1075.0
44656,110653,81993,18960,50226,31767,10201,358,-2964.0
47513,105530,72275,15707,50308,21967,4914,103,-1449.0
40800,111014,88502,21741,46558,41944,17898,1148,-3453.0
41289,111206,87849,21400,47298,40551,16610,927,-3468.0
40234,110618,88989,22020,45858,43131,18902,1206,-3415.0
45049,109487,80092,18345,50114,29978,9259,317,-2691.0
47987,103187,69037,14725,49724,19313,3739,39,-888.0
47983,105931,72270,15661,50574,21696,4783,87,-1339.0
47740,105179,71710,15539,50186,21524,4807,90,-1268.0
41098,111146,88137,21538,47046,41091,17054,950,-3449.0
22336,35236,18488,3227,17614,874,8,0,2361.0
48782,102910,67962,14355,49794,18168,3322,30,-521.0
37849,109818,93366,24303,40914,52452,27990,2747,-2906.0
41272,110949,87564,21323,47190,40374,16569,954,-3436.0
40741,111105,88863,21904,46302,42561,18501,1249,-3405.0
48043,101923,67496,14277,49330,18166,3263,35,-661.0
45275,81884,48207,9292,40662,7545,560,1,2306.0
43020,110848,84612,20048,48936,35676,12976,612,-3264.0
15002,23191,11941,2048,11594,347,3,0,1704.0
37886,109885,93474,24351,40842,52632,28201,2796,-2876.0
44704,110257,81505,18822,50078,31427,10101,366,-2870.0
48523,96199,60720,12377,47178,13542,1843,11,667.0
2480,3736,1876,314,1868,8,0,0,306.0
40257,111174,89667,22231,45948,43719,19278,1271,-3481.0
40834,111372,89070,21946,46464,42606,18444,1198,-3414.0
44048,111385,83751,19590,49962,33789,11461,438,-3176.0
45686,109278,79000,17921,50474,28526,8330,238,-2513.0
48204,99384,64529,13447,48376,16153,2632,24,-98.0
38170,64787,36247,6698,32306,3941,175,0,2932.0
45803,109067,78460,17717,50618,27842,7831,227,-2521.0
48089,93775,58496,11817,46090,12406,1595,13,993.0
44187,110454,82331,19122,49930,32401,10594,373,-3058.0
48978,98892,63281,13042,48310,14971,2272,18,325.0
36091,107917,97617,27179,32160,65457,43597,6707,-1388.0
29720,48450,26179,4692,24206,1973,38,0,2757.0
48295,104546,70350,15083,50202,20148,4142,61,-984.0
35628,106304,99465,28989,24996,74469,56312,11032,-200.0
35599,105823,99787,29508,22526,77261,60771,12963,55.0
32038,52677,28679,5175,26308,2371,61,0,2865.0
48327,102155,67576,14295,49382,18194,3391,39,-547.0
29686,48247,26002,4650,24104,1898,39,0,2791.0
45495,109693,79781,18188,50434,29347,8825,271,-2605.0
37548,63738,35652,6585,31794,3858,150,0,2877.0
35784,104870,100807,31160,14654,86153,75562,20008,561.0
37670,109884,93965,24591,40384,53581,29116,2966,-2840.0
48757,99485,64147,13299,48500,15647,2485,17,120.0
35675,105238,100411,30432,18230,82181,68778,16613,416.0
37127,109350,94852,25181,38618,56234,32114,3613,-2552.0
29230,47553,25647,4589,23760,1887,33,0,2735.0
35629,106154,99606,29192,24060,75546,58034,11791,-111.0
48416,102223,67504,14252,49496,18008,3231,30,-555.0
35240,58998,32623,5967,29444,3179,110,0,2898.0
42802,76199,44307,8454,37890,6417,419,0,2456.0
47835,91829,56630,11338,45232,11398,1365,7,1298.0
37962,64615,36221,6702,32230,3991,155,0,2866.0
25762,41119,21803,3842,20554,1249,11,0,2604.0
47899,92657,57422,11535,45634,11788,1389,7,1129.0
48410,101526,66767,14057,49192,17575,3142,30,-406.0
44910,110655,81717,18850,50334,31383,9987,332,-2878.0
38017,110131,93470,24286,41224,52246,27683,2653,-2930.0
6324,9608,4865,821,4804,61,0,0,760.0
38085,110092,93339,24241,41232,52107,27628,2671,-2909.0
48316,101853,67194,14177,49326,17868,3201,30,-520.0
29478,48109,26027,4671,24028,1999,53,0,2725.0
35957,107596,97988,27519,30862,67126,45872,7435,-1170.0
47790,106584,73257,15971,50688,22569,5208,118,-1508.0
8492,12956,6587,1116,6478,109,0,0,1007.0
42369,111041,85715,20479,48556,37159,13929,685,-3436.0
45918,84311,50218,9771,41810,8408,691,0,2054.0
49211,99000,63139,12973,48440,14699,2120,17,377.0
48343,100941,66175,13899,48956,17219,3029,31,-322.0
47925,105397,71708,15507,50374,21334,4649,93,-1271.0
48311,102869,68429,14543,49600,18829,3669,55,-672.0
44034,78842,46054,8821,39182,6872,478,2,2425.0
41117,111142,88285,21629,46796,41489,17550,1059,-3369.0
33222,54807,29926,5414,27368,2558,71,0,2927.0
45966,108545,77731,17499,50468,27263,7609,192,-2347.0
35769,107120,98377,27905,29324,69053,48472,8203,-879.0
44022,78869,46105,8838,39182,6923,505,0,2420.0
48836,98968,63500,13114,48316,15184,2336,12,254.0
47202,108185,75826,16783,50954,24872,6277,128,-1940.0
35936,104544,101360,32696,6544,94816,91456,29280,56.0
47957,106363,72759,15791,50772,21987,4819,61,-1438.0
41835,73794,42576,8069,36738,5838,318,1,2548.0
36715,108812,95393,25590,37246,58147,34320,4057,-2294.0
46558,107949,76263,16983,50628,25635,6693,152,-2111.0
46702,108599,76822,17119,50930,25892,6739,160,-2194.0
37437,109500,94226,24833,39454,54772,30592,3323,-2670.0
37051,109262,95111,25344,38158,56953,32946,3781,-2444.0
28694,46771,25268,4528,23368,1900,35,0,2663.0
47487,107178,74329,16321,50732,23597,5714,121,-1683.0
42211,110760,85885,20626,48014,37871,14732,777,-3290.0
36616,61620,34218,6281,30750,3468,120,0,2933.0
36566,108511,96553,26382,34814,61739,38883,5300,-1774.0
48518,102453,67693,14303,49568,18125,3317,40,-545.0
35570,105899,99715,29373,23192,76523,59515,12352,13.0
47984,105054,71287,15388,50246,21041,4562,80,-1171.0
48783,98588,63084,12995,48198,14886,2192,17,284.0
38577,110496,92743,23865,42296,50447,25904,2363,-3041.0
43864,110747,83236,19470,49652,33584,11443,446,-3117.0
48472,104687,70368,15079,50262,20106,4163,62,-926.0
15132,23406,12058,2069,11702,356,2,0,1715.0
35901,107547,97949,27484,30994,66955,45559,7269,-1181.0
48015,98127,63334,13140,47828,15506,2471,23,82.0
45756,109408,79079,17938,50530,28549,8348,248,-2511.0
47190,106997,74499,16415,50508,23991,5981,128,-1723.0
45415,82810,49065,9507,41088,7977,634,1,2163.0
19970,31473,16498,2877,15734,764,5,0,2118.0
40842,70935,40433,7588,35338,5095,259,0,2752.0
43789,110895,83543,19585,49576,33967,11743,509,-3148.0
44307,110786,82658,19220,49996,32662,10794,393,-3041.0
47435,89717,54675,10838,44322,10353,1073,3,1555.0
35953,107706,97669,27262,31766,65903,44174,6879,-1346.0
20962,33137,17420,3046,16564,856,9,0,2199.0
35927,107574,97572,27236,31728,65844,44118,6821,-1311.0
42274,111007,86065,20661,48164,37901,14679,768,-3329.0
35936,104546,101343,32581,7200,94143,90146,28432,152.0
41396,110980,87377,21231,47368,40009,16244,904,-3438.0
2616,3936,1974,330,1968,6,0,0,324.0
35740,104945,100774,31011,15482,85292,73981,19142,558.0
43783,110597,83174,19468,49540,33634,11517,459,-3108.0
45880,109209,78673,17801,50540,28133,8129,254,-2457.0
45675,84691,50864,9969,41914,8950,863,3,1879.0
35808,107125,98251,27836,29486,68765,48153,8126,-902.0
35656,106750,98978,28453,27238,71740,52274,9556,-569.0
43283,76552,44271,8408,38094,6177,364,1,2594.0
38110,110085,93387,24268,41166,52221,27753,2656,-2856.0
35854,104745,101069,31630,12358,88711,80029,22400,548.0
39938,110606,89777,22413,45076,44701,20454,1470,-3304.0
35650,105317,100428,30386,18540,81888,68237,16360,375.0
42519,110850,85421,20399,48448,36973,13954,689,-3309.0
41817,111031,86831,20995,47692,39139,15647,881,-3378.0
35911,104583,101240,32198,9292,91948,85999,25879,370.0
47494,106466,73385,16023,50632,22753,5202,82,-1610.0
38096,64942,36457,6755,32384,4073,174,0,2856.0
48744,99960,64690,13452,48668,16022,2624,32,22.0
43377,110637,83822,19733,49246,34576,12145,473,-3171.0
47131,107249,74725,16456,50714,24011,5821,115,-1849.0
48526,103535,68908,14641,49970,18938,3595,40,-742.0
35573,105768,99961,29671,21896,78065,61976,13487,95.0
35911,104588,101248,32194,9332,91916,85924,25825,377.0
39814,110720,89889,22417,45276,44613,20168,1406,-3434.0
48492,103252,68663,14586,49810,18853,3632,48,-683.0
25364,40458,21440,3776,20224,1216,10,0,2570.0
38592,110353,92257,23636,42698,49559,24957,2174,-3140.0
46863,106272,73910,16257,50278,23632,5716,97,-1756.0
48564,103655,69056,14690,49972,19084,3711,42,-725.0
10062,15417,7871,1339,7708,163,1,0,1177.0
22318,35213,18477,3225,17604,873,5,0,2357.0
47768,105348,71781,15535,50352,21429,4644,84,-1334.0
39192,67210,37913,7053,33508,4405,194,0,2842.0
47155,107208,74573,16392,50794,23779,5620,105,-1872.0
46846,107666,75647,16781,50608,25039,6450,146,-1954.0
48759,98701,63319,13082,48146,15173,2409,23,295.0
47285,106726,74029,16257,50516,23513,5694,107,-1669.0
38638,110280,91937,23493,42916,49021,24448,2118,-3198.0
41881,111177,86906,20996,47836,39070,15505,817,-3386.0
45720,109258,78818,17838,50608,28210,8042,228,-2558.0
35899,104603,101175,32071,9924,91251,84755,25175,400.0
45414,109123,79130,17993,50302,28828,8519,256,-2572.0
39168,67562,38291,7151,33676,4615,210,0,2746.0
48517,101021,66056,13840,49072,16984,2877,21,-288.0
45389,108851,78863,17926,50170,28693,8511,269,-2525.0
47088,108287,76084,16877,50906,25178,6475,166,-1992.0
35783,107110,98286,27871,29346,68940,48418,8261,-912.0
35938,104542,101353,32696,6530,94823,91482,29302,53.0
48436,100039,65097,13597,48612,16485,2815,30,-103.0
24056,38392,20356,3587,19190,1166,12,0,2433.0
45511,110272,80364,18334,50724,29640,8824,249,-2731.0
22012,34814,18308,3202,17404,904,6,0,2304.0
35932,107820,97416,27021,32706,64710,42408,6212,-1493.0
47057,106468,73894,16228,50420,23474,5628,127,-1745.0
32244,52900,28747,5179,26420,2327,60,0,2912.0
34680,57776,31814,5798,28840,2974,96,0,2920.0
41312,72128,41288,7776,35920,5368,288,0,2696.0
34038,56347,30856,5596,28136,2720,75,0,2951.0
33322,55231,30279,5497,27576,2703,79,0,2873.0
36336,108260,97038,26723,33738,63300,40784,5816,-1609.0
47669,89964,54736,10836,44456,10280,1052,3,1605.0
46790,107782,75868,16858,50588,25280,6606,166,-1982.0
44722,109489,80413,18465,50036,30377,9417,324,-2819.0
48530,103810,69194,14716,50092,19102,3626,42,-802.0
43893,110491,82882,19364,49580,33302,11331,473,-3080.0
37695,64376,36202,6719,32090,4112,196,1,2802.0
48015,104755,70836,15239,50238,20598,4279,63,-1143.0
7432,11344,5770,978,5672,98,0,0,880.0
43804,110554,83030,19411,49594,33436,11366,472,-3131.0
44234,110156,81951,19012,49830,32121,10496,370,-2983.0
35692,106189,99358,28990,24776,74582,56637,11174,-129.0
36296,60914,33737,6177,30412,3325,90,0,2942.0
37598,109793,94379,24847,39676,54703,30441,3248,-2663.0
35661,105321,100369,30328,18770,81599,67781,16129,381.0
36305,108519,96992,26591,34438,62554,39643,5493,-1813.0
48286,102512,68042,14435,49474,18568,3564,50,-619.0
48241,94737,59379,12036,46542,12837,1653,5,847.0
48240,102970,68568,14577,49674,18894,3622,44,-739.0
47866,93141,57976,11687,45830,12146,1481,8,1014.0
48425,98759,63638,13184,48172,15466,2415,13,120.0
38352,65178,36485,6742,32518,3967,142,0,2917.0
35667,105096,100620,30702,17028,83592,71040,17661,489.0
47712,105970,72618,15791,50490,22128,4990,84,-1431.0
43523,78136,45751,8782,38810,6941,516,1,2356.0
42326,111124,86241,20729,48108,38133,14908,790,-3286.0
46186,108332,77231,17328,50494,26737,7344,178,-2243.0
47554,91068,56018,11187,44914,11104,1240,6,1317.0
37433,109462,94124,24787,39526,54598,30410,3291,-2692.0
22126,35003,18412,3221,17498,914,7,0,2314.0
36368,108311,96692,26508,34336,62356,39639,5550,-1759.0
36100,107926,97385,27007,32728,64657,42470,6268,-1448.0
35674,105171,100554,30568,17700,82854,69771,16996,489.0
41008,111152,88517,21741,46588,41929,17976,1156,-3368.0
19026,29809,15540,2696,14904,636,1,0,2061.0
33972,56364,30919,5615,28148,2771,68,0,2912.0
44551,110744,82250,19058,50152,32098,10440,401,-3001.0
44036,78518,45720,8735,39030,6690,458,0,2503.0
48505,95798,60275,12252,47038,13237,1722,7,730.0
48366,96202,60903,12448,47118,13785,1966,10,619.0
35714,105448,100252,30156,19568,80684,66312,15422,362.0
46983,108274,76156,16901,50906,25250,6462,149,-2036.0
35793,104801,100986,31429,13398,87588,78005,21297,549.0
43286,111079,84439,19930,49298,35141,12483,556,-3284.0
35830,104715,101051,31600,12502,88549,79711,22196,566.0
46988,107159,74888,16545,50506,24382,6147,138,-1828.0
36797,108934,95610,25708,36972,58638,34990,4295,-2235.0
47525,91965,57028,11464,45272,11756,1421,5,1124.0
42339,111058,85979,20606,48322,37657,14414,709,-3346.0
45285,108468,78437,17790,50134,28303,8200,223,-2536.0
46792,86631,51941,10162,42910,9031,811,2,1940.0
45567,109428,79270,18003,50522,28748,8384,233,-2594.0
48094,103785,69649,14897,49916,19733,3953,56,-939.0
47954,103967,70024,15024,49904,20120,4159,76,-1013.0
18526,29007,15114,2621,14502,612,3,0,2012.0
35665,105693,100057,29830,21134,78923,63425,14133,199.0
48781,101035,65861,13773,49084,16777,2867,29,-166.0
47117,107100,74592,16426,50628,23964,5844,123,-1817.0
47429,107083,74209,16274,50774,23435,5535,93,-1719.0
41551,111269,87567,21278,47466,40101,16337,943,-3429.0
43432,111035,84198,19838,49368,34830,12299,550,-3243.0
43363,110733,84112,19865,49034,35078,12665,575,-3123.0
47787,106238,72886,15869,50558,22328,5122,97,-1434.0
42655,110781,85185,20310,48510,36675,13761,647,-3251.0
35583,106484,99099,28653,26280,72819,53924,10213,-455.0
48957,102951,67884,14330,49788,18096,3375,49,-440.0
47123,107365,74957,16544,50650,24307,6065,131,-1829.0
36598,108824,96273,26099,35952,60321,36920,4750,-2052.0
48117,91653,56148,11176,45240,10908,1173,5,1436.0
42999,75902,43831,8315,37772,6059,358,1,2613.0
43696,110124,82772,19378,49276,33496,11572,488,-3034.0
34863,58286,32189,5881,29092,3097,102,1,2885.0
41374,110990,87375,21224,47406,39969,16178,898,-3465.0
47295,90489,55638,11109,44622,11016,1245,3,1335.0
44101,110587,82650,19240,49860,32790,10867,393,-3076.0
48444,100908,66049,13856,48962,17087,2984,24,-271.0
39770,110781,90329,22650,44758,45571,21265,1676,-3332.0
41623,111129,87289,21185,47468,39821,16193,959,-3402.0
45748,109943,79633,18080,50786,28847,8371,246,-2642.0
47626,105918,72551,15758,50554,21997,4810,70,-1499.0
40240,111036,89595,22238,45762,43833,19512,1356,-3439.0
44963,109948,80618,18478,50368,30250,9212,285,-2845.0
35689,105125,100629,30686,17142,83487,70841,17533,507.0
48111,94228,58951,11933,46304,12647,1620,5,901.0
46394,108365,76836,17145,50802,26034,6761,152,-2280.0
43874,110833,83424,19543,49590,33834,11653,440,-3078.0
45015,109402,80076,18352,50040,30036,9322,301,-2663.0
47537,106336,73263,16002,50514,22749,5308,99,-1538.0
47265,106439,73617,16122,50502,23115,5435,121,-1679.0
48628,99253,64022,13279,48370,15652,2513,22,118.0
17624,27552,14336,2483,13774,562,4,0,1925.0
43207,110718,84093,19832,49194,34899,12330,513,-3250.0
40076,110951,90110,22518,45112,44998,20727,1530,-3283.0
42478,110913,85410,20366,48624,36786,13665,636,-3391.0
42286,111231,86293,20719,48272,38021,14687,756,-3371.0
47842,105809,72266,15671,50506,21760,4797,80,-1372.0
32446,53291,28986,5226,26616,2370,59,0,2915.0
47017,107989,75840,16819,50766,25074,6457,153,-1951.0
280,420,210,35,210,0,0,0,35.0
35694,106764,98678,28255,27826,70852,51112,9162,-647.0
36635,108760,96321,26152,35730,60591,37300,4817,-1956.0
48937,100266,64859,13482,48826,16033,2614,15,48.0
47229,107236,74649,16434,50694,23955,5848,119,-1792.0
38333,110110,92954,24062,41536,51418,27038,2567,-2885.0
36661,108711,95959,25981,36032,59927,36647,4773,-2072.0
34846,57923,31834,5792,28916,2918,91,0,2965.0
40960,111014,88178,21586,46840,41338,17334,1044,-3462.0
35680,105365,100278,30219,19242,81036,66881,15690,374.0
43189,111121,84631,20001,49256,35375,12609,537,-3302.0
39340,110939,91464,23133,44130,47334,22679,1746,-3268.0
47554,91817,56850,11416,45204,11646,1409,8,1171.0
35692,106667,98996,28529,26818,72178,53031,9890,-508.0
35880,107325,98040,27638,30252,67788,46821,7714,-1043.0
48597,96384,60834,12397,47286,13548,1812,11,650.0
38437,110311,92722,23885,42134,50588,26043,2377,-3037.0
47171,107530,75102,16583,50706,24396,6118,145,-1840.0
35900,104593,101226,32129,9678,91548,85237,25414,404.0
5500,8356,4231,714,4178,53,0,0,661.0
44191,109589,81338,18840,49636,31702,10317,355,-2900.0
47876,103948,70053,15031,49920,20133,4108,56,-1050.0
46963,107834,75668,16764,50752,24916,6330,145,-1967.0
35579,105849,99874,29536,22532,77342,60785,12911,68.0
45795,85125,51209,10048,42130,9079,865,3,1831.0
47672,105099,71656,15523,50174,21482,4751,86,-1294.0
47975,92091,56764,11357,45386,11378,1319,7,1291.0
39668,68692,39081,7326,34206,4875,280,0,2731.0
36653,108765,95846,25881,36406,59440,35953,4541,-2147.0
37863,64786,36475,6774,32306,4169,174,1,2778.0
48530,99294,64117,13304,48410,15707,2474,22,49.0
47552,106780,73715,16117,50728,22987,5324,84,-1630.0
36473,108464,96176,26141,35506,60670,37452,4879,-1956.0
42776,75528,43632,8281,37578,6054,372,0,2599.0
47395,89148,54124,10700,44048,10076,1052,5,1671.0
47742,90742,55503,11034,44802,10701,1138,2,1469.0
45650,109878,79744,18140,50648,29096,8582,250,-2624.0
39853,110756,90093,22528,45018,45075,20720,1511,-3338.0
38214,65533,36963,6875,32676,4287,181,0,2769.0
35991,107631,97411,27122,32090,65321,43451,6603,-1351.0
46317,86065,51748,10148,42608,9140,849,5,1852.0
44631,80653,47494,9163,40010,7484,633,3,2309.0
25394,40493,21456,3779,20238,1218,17,0,2578.0
45407,109663,79728,18156,50520,29208,8623,255,-2684.0
35603,105775,99952,29635,22094,77858,61587,13219,145.0
41840,111087,86828,20977,47794,39034,15499,838,-3396.0
35774,104826,100900,31282,14108,86792,76610,20534,566.0
47393,90076,55129,10971,44432,10697,1212,11,1475.0
42842,111350,85504,20349,48914,36590,13522,634,-3353.0
48196,104993,70883,15226,50410,20473,4173,66,-1140.0
47820,92233,57046,11443,45434,11612,1365,6,1190.0
44434,79991,46899,9006,39762,7137,467,0,2336.0
48603,96476,60969,12442,47286,13683,1904,9,654.0
15858,24659,12767,2201,12328,439,3,0,1765.0
24162,38451,20339,3577,19216,1123,19,0,2473.0
35713,105156,100598,30657,17254,83344,70648,17463,498.0
46176,85061,50790,9902,42168,8622,725,2,2003.0
35891,104616,101166,31995,10362,90804,83892,24637,446.0
35889,104583,101244,32151,9582,91662,85419,25509,399.0
4120,6216,3126,524,3108,18,0,0,506.0
35164,58632,32313,5894,29262,3051,108,0,2951.0
37788,109672,93390,24358,40632,52758,28408,2860,-2852.0
46554,108057,76414,17032,50636,25778,6785,160,-2121.0
43777,111268,84017,19719,49720,34297,11828,443,-3193.0
47150,89324,54511,10819,44108,10403,1108,6,1518.0
47296,89782,54876,10905,44322,10554,1138,4,1485.0
35890,107517,98004,27526,30852,67152,45813,7336,-1149.0
41741,111304,87262,21124,47780,39482,15744,811,-3425.0
35803,104859,100907,31264,14230,86677,76399,20399,587.0
49235,100665,65048,13514,49012,16036,2641,15,104.0
43817,110581,83088,19435,49566,33522,11449,473,-3111.0
35605,106185,99381,29014,24678,74703,56829,11353,-213.0
43382,110842,84019,19788,49310,34709,12222,530,-3229.0
48652,102247,67419,14235,49428,17991,3391,46,-411.0
40680,111173,88595,21713,46912,41683,17349,990,-3611.0
45421,109307,79258,18010,50456,28802,8395,241,-2638.0
47421,92174,57361,11566,45326,12035,1522,11,1042.0
37136,109422,94994,25228,38620,56374,32182,3556,-2520.0
35796,104808,100898,31341,13750,87148,77308,20956,545.0
47846,105374,71747,15520,50374,21373,4626,74,-1301.0
35664,106811,98558,28127,28354,70204,50103,8742,-716.0
43823,110501,82922,19367,49642,33280,11217,427,-3123.0
47718,106428,73119,15930,50658,22461,5112,102,-1521.0
48374,95260,59838,12152,46764,13074,1732,10,800.0
47197,89438,54574,10828,44180,10394,1078,7,1505.0
48573,95677,60123,12215,46956,13167,1765,9,804.0
36518,108620,96433,26259,35312,61121,37996,5062,-1928.0
35504,59348,32768,5985,29626,3142,96,0,2939.0
44501,109965,81367,18798,49946,31421,10073,345,-2895.0
44955,110275,80998,18588,50468,30530,9339,307,-2910.0
44835,110170,81048,18624,50352,30696,9466,305,-2911.0
32514,53881,29542,5365,26894,2648,93,0,2810.0
21732,34302,18008,3145,17146,862,10,0,2293.0
40468,69614,39378,7344,34692,4686,230,0,2888.0
45887,110085,79728,18112,50784,28944,8517,267,-2582.0
23600,37586,19893,3500,18786,1107,14,0,2407.0
40506,110853,89020,22021,45914,43106,19025,1288,-3348.0
48487,99381,64315,13377,48368,15947,2645,31,44.0
20618,32507,17049,2975,16248,801,11,0,2185.0
41613,110994,87270,21201,47334,39936,16326,903,-3312.0
48238,103933,69708,14906,49980,19728,3973,44,-893.0
43868,110694,83138,19433,49678,33460,11338,432,-3121.0
20786,32681,17096,2976,16336,760,9,0,2225.0
48257,101964,67398,14244,49332,18066,3300,31,-553.0
48808,94672,58843,11856,46550,12293,1572,12,1123.0
37006,109011,94940,25334,37876,57064,33259,3928,-2399.0
48232,105424,71373,15368,50538,20835,4348,68,-1187.0
48466,104508,70135,15006,50234,19901,4040,58,-913.0
39766,110888,90221,22536,45226,44995,20436,1414,-3437.0
7228,10980,5559,938,5490,69,0,0,869.0
40828,111169,88776,21848,46464,42312,18241,1190,-3413.0
35583,105765,99845,29554,22366,77479,61033,12999,109.0
42634,75065,43254,8190,37368,5886,329,0,2633.0
47728,105360,71793,15532,50394,21399,4572,76,-1371.0
14716,22768,11731,2013,11384,347,0,0,1666.0
48604,101126,66103,13849,49112,16991,2902,28,-268.0
41764,73104,41931,7910,36402,5529,300,0,2681.0
39113,110243,90713,22903,44008,46705,22227,1745,-3320.0
40640,110902,88703,21853,46288,42415,18326,1176,-3412.0
34645,58101,32175,5893,28992,3183,117,1,2826.0
46881,107398,75278,16667,50554,24724,6290,139,-1906.0
44782,110536,81727,18875,50204,31523,10128,382,-2902.0
48130,103305,69099,14745,49728,19371,3849,44,-821.0
48621,99310,64122,13314,48360,15762,2590,23,119.0
35748,104909,100883,31138,14938,85945,75033,19642,584.0
37784,109948,94004,24611,40342,53662,29264,2984,-2771.0
47365,106389,73419,16045,50568,22851,5253,97,-1650.0
45415,109395,79490,18105,50350,29140,8695,255,-2595.0
39132,110627,91395,23162,43818,47577,22991,1838,-3262.0
43613,110830,83629,19616,49562,34067,11706,459,-3204.0
35922,104566,101304,32442,7956,93348,88654,27530,218.0
44894,110416,81430,18766,50264,31166,9888,346,-2858.0
43777,111021,83816,19689,49498,34318,12025,513,-3117.0
27548,44546,23900,4257,22258,1642,30,0,2645.0
44667,110885,82402,19111,50138,32264,10609,383,-2927.0
35646,105706,99917,29713,21556,78361,62594,13802,144.0
48490,105337,71084,15278,50500,20584,4337,72,-1041.0
35629,106136,99519,29149,24144,75375,57848,11759,-137.0
35879,104637,101126,31880,10972,90154,82693,23931,488.0
48107,103341,69093,14730,49806,19287,3729,43,-871.0
36228,108205,96768,26545,34266,62502,39673,5470,-1754.0
37822,109774,93721,24519,40328,53393,29118,2994,-2750.0
41363,111093,87641,21339,47248,40393,16597,971,-3428.0
35932,104549,101299,32469,7784,93515,88981,27722,213.0
35902,60127,33252,6082,30012,3240,103,0,2945.0
38407,110318,92827,23931,42068,50759,26182,2369,-3015.0
47110,107781,75403,16658,50858,24545,6065,104,-1926.0
38366,110287,93139,24119,41564,51575,27159,2604,-2901.0
45170,109342,79654,18170,50288,29366,8766,258,-2688.0
45807,84026,50020,9730,41660,8360,706,5,2071.0
48256,104253,70036,14995,50102,19934,4049,66,-956.0
15340,23754,12250,2104,11876,374,2,0,1732.0
47292,107084,74363,16336,50710,23653,5664,112,-1765.0
48462,96038,60581,12340,47122,13459,1794,10,665.0
48187,104790,70695,15182,50298,20397,4194,69,-1090.0
47143,107958,75576,16708,50904,24672,6150,133,-1947.0
39132,67288,38027,7083,33556,4471,176,0,2788.0
47204,89526,54672,10855,44214,10458,1098,0,1495.0
46983,107568,75202,16595,50834,24368,5900,105,-1978.0
36177,108362,96978,26592,34404,62574,39554,5371,-1799.0
5136,7788,3936,663,3894,42,0,0,621.0
35750,104893,100875,31180,14670,86205,75553,19976,552.0
46982,107174,74882,16534,50560,24322,6054,110,-1844.0
35914,104584,101278,32278,8888,92390,86808,26366,330.0
30742,50341,27309,4912,25146,2163,49,0,2798.0
47128,89060,54237,10745,44004,10233,1052,4,1560.0
47678,102371,68398,14572,49364,19034,3643,48,-867.0
33252,55230,30330,5514,27576,2754,78,0,2838.0
37358,109417,94598,25056,38860,55738,31697,3532,-2517.0
43041,110565,84248,19934,48892,35356,12781,569,-3210.0
46902,87656,52951,10425,43352,9599,952,6,1772.0
35726,106952,98530,28060,28700,69830,49552,8538,-756.0
35649,105308,100265,30200,19330,80935,66648,15507,406.0
47646,90764,55625,11078,44782,10843,1200,6,1429.0
46207,109116,78004,17522,50876,27128,7364,185,-2427.0
31392,51416,27894,5017,25686,2208,44,0,2853.0
43938,78063,45317,8635,38824,6493,415,0,2557.0
42350,74659,43078,8168,37148,5930,363,0,2601.0
48867,100262,64941,13517,48780,16161,2702,29,29.0
44987,110049,80830,18565,50270,30560,9509,311,-2797.0
36980,62340,34665,6370,31110,3555,120,0,2935.0
46613,108652,77013,17191,50880,26133,6892,167,-2217.0
42839,75878,43953,8362,37734,6219,410,1,2552.0
48114,94612,59407,12066,46418,12989,1776,10,843.0
35597,106134,99644,29226,23932,75712,58270,11903,-119.0
45525,109679,79591,18099,50588,29003,8503,261,-2662.0
40541,111007,89064,22012,46056,43008,18895,1313,-3414.0
37550,63865,35783,6619,31852,3931,161,0,2849.0
44184,110064,81760,18932,49928,31832,10208,360,-3052.0
46377,108879,77536,17367,50870,26666,7139,173,-2333.0
48295,96161,60870,12433,47142,13728,1877,11,571.0
38873,110621,92198,23569,42982,49216,24657,2129,-3119.0
32972,54644,29957,5439,27280,2677,84,0,2846.0
37655,109732,94205,24777,39748,54457,30236,3205,-2649.0
35758,107176,98438,27925,29326,69112,48524,8242,-905.0
48024,93791,58525,11819,46136,12389,1519,10,939.0
46353,108855,77576,17389,50818,26758,7219,165,-2315.0
48108,93919,58588,11829,46202,12386,1515,10,948.0
44283,110715,82406,19106,50176,32230,10363,371,-3132.0
45466,82839,49065,9506,41094,7971,651,0,2186.0
42683,111075,85543,20430,48506,37037,14063,735,-3279.0
48413,103880,69496,14838,49964,19532,3952,67,-809.0
46163,85852,51631,10123,42524,9107,804,1,1819.0
35844,104792,101011,31493,13064,87947,78664,21640,570.0
47144,108777,76604,17021,51082,25522,6613,162,-2050.0
48760,99800,64483,13389,48632,15851,2536,20,54.0
44665,80991,47779,9225,40208,7571,575,1,2228.0
45592,83342,49471,9599,41348,8123,646,0,2122.0
41484,72476,41513,7823,36088,5425,300,0,2698.0
45225,110072,80543,18443,50428,30115,9216,291,-2747.0
48443,103207,68649,14585,49788,18861,3631,55,-700.0
36128,108004,97082,26795,33394,63688,41216,5912,-1589.0
14654,22725,11735,2018,11362,373,1,0,1646.0
43565,110853,84004,19805,49178,34826,12497,565,-3089.0
46881,107856,75677,16752,50842,24835,6172,139,-2050.0
39567,110735,90915,22943,44172,46743,22391,1787,-3196.0
46646,108346,76628,17078,50788,25840,6770,158,-2150.0
21598,33997,17801,3101,16996,805,5,0,2301.0
46471,85516,51010,9935,42410,8600,696,1,2030.0
44479,80302,47225,9097,39868,7357,566,1,2305.0
12816,19770,10159,1739,9884,275,2,0,1466.0
45868,109046,78506,17751,50506,28000,8034,208,-2423.0
41232,111360,88314,21601,47022,41292,17316,1040,-3415.0
35646,105829,99873,29594,22182,77691,61465,13272,96.0
36320,60870,33683,6164,30382,3301,106,0,2969.0
2104,3164,1586,265,1582,4,0,0,261.0
35601,106359,99269,28843,25480,73789,55399,10785,-332.0
35676,106041,99496,29203,23774,75722,58493,12046,-72.0
46416,86866,52528,10350,42956,9572,954,4,1728.0
43440,111027,84255,19869,49296,34959,12435,546,-3201.0
46829,107902,75748,16766,50900,24848,6102,111,-2091.0
39866,110840,89965,22436,45314,44651,20212,1442,-3445.0
48584,101906,67037,14119,49360,17677,3186,32,-404.0
17688,27584,14318,2474,13792,526,0,0,1948.0
38596,66074,37218,6915,32946,4272,182,0,2825.0
48818,101854,66744,14015,49398,17346,3058,34,-307.0
37502,109563,94027,24698,39866,54161,29831,3100,-2732.0
45032,110015,80718,18522,50304,30414,9407,302,-2787.0
48468,100853,65886,13792,49020,16866,2813,30,-291.0
36780,109034,95738,25722,37144,58594,34746,4112,-2238.0
48653,105596,71128,15253,50738,20390,4120,51,-1068.0
48352,100311,65472,13706,48708,16764,2895,30,-193.0
46632,108368,76664,17090,50788,25876,6792,168,-2162.0
48827,103065,68169,14428,49770,18399,3525,51,-497.0
39501,110856,90673,22747,44864,45809,21128,1495,-3429.0
36870,61979,34378,6303,30938,3440,103,0,2966.0
47237,106936,74312,16344,50560,23752,5816,139,-1731.0
48856,100067,64640,13412,48808,15832,2451,14,17.0
40195,110899,89338,22127,45914,43424,19071,1267,-3493.0
15354,23869,12354,2129,11934,420,1,0,1710.0
46279,109143,78108,17581,50730,27378,7683,223,-2337.0
47717,106226,72869,15854,50614,22255,4998,91,-1494.0
47417,106350,73374,16040,50508,22866,5334,107,-1599.0
36054,60621,33633,6168,30258,3375,105,0,2898.0
36124,60776,33749,6196,30322,3427,132,0,2901.0
35934,104543,101332,32587,7142,94190,90259,28520,136.0
45046,110580,81447,18753,50376,31071,9828,350,-2840.0
33726,56025,30767,5593,27976,2791,73,0,2875.0
47738,106276,72966,15894,50568,22398,5140,102,-1466.0
35920,104559,101298,32391,8250,93048,88059,27134,268.0
30474,49947,27113,4879,24952,2161,43,0,2761.0
38455,110550,92606,23734,42808,49798,24934,2093,-3223.0
47201,106427,73737,16174,50430,23307,5567,97,-1663.0
36586,61245,33858,6191,30570,3288,105,0,3008.0
35846,104676,101085,31765,11580,89505,81516,23286,490.0
35598,105685,100143,29861,21120,79023,63445,14088,195.0
22444,35724,18899,3324,17854,1045,16,0,2295.0
46839,87721,53086,10468,43364,9722,993,3,1736.0
36322,60941,33764,6187,30406,3358,129,0,2958.0
44881,110126,80934,18585,50358,30576,9410,315,-2896.0
46537,86487,51997,10194,42830,9167,827,1,1853.0
43415,110550,83548,19625,49346,34202,11858,493,-3212.0
46077,109429,78657,17759,50760,27897,7909,225,-2454.0
47732,106806,73498,16026,50840,22658,5126,96,-1602.0
35601,105930,99734,29370,23248,76486,59434,12283,35.0
47400,106356,73453,16074,50462,22991,5432,92,-1577.0
48819,101199,65965,13789,49196,16769,2807,31,-204.0
36174,108051,97256,26916,33016,64240,42019,6232,-1537.0
46858,88458,53805,10646,43734,10071,990,6,1559.0
38587,110455,92105,23510,43150,48955,24155,1983,-3273.0
38283,110230,93274,24197,41366,51908,27498,2657,-2870.0
40590,110867,88578,21788,46428,42150,18011,1136,-3487.0
35861,107396,97682,27371,31138,66544,45120,7171,-1224.0
35801,106944,98568,28129,28362,70206,50220,8847,-704.0
35842,104723,101045,31614,12406,88639,79911,22336,550.0
45022,109576,80215,18383,50132,30083,9312,334,-2722.0
35765,106976,98395,27965,29000,69395,48976,8327,-781.0
46218,109394,78357,17630,50934,27423,7526,182,-2449.0
35650,106227,99457,29041,24668,74789,56891,11304,-161.0
43157,110678,84078,19832,49164,34914,12350,543,-3275.0
48563,103083,68378,14494,49792,18586,3499,43,-636.0
38243,110203,92799,23922,42066,50733,26071,2343,-3083.0
48792,98481,63028,12995,48086,14942,2309,18,344.0
47884,105439,71764,15518,50420,21344,4599,82,-1309.0
42619,110986,85538,20439,48442,37096,14102,713,-3268.0
26306,42125,22404,3959,21054,1350,17,0,2626.0
43446,110738,83900,19765,49210,34690,12318,550,-3157.0
48286,104998,70950,15270,50280,20670,4438,70,-1032.0
43878,78612,45944,8804,39064,6880,484,2,2406.0
45140,110050,80606,18474,50368,30238,9314,328,-2778.0
48688,100712,65571,13697,48960,16611,2792,28,-150.0
48239,95882,60680,12402,46948,13732,1986,21,635.0
47827,93365,58250,11763,45922,12328,1521,7,949.0
38648,110391,92379,23705,42528,49851,25335,2258,-3069.0
45270,109709,80022,18279,50370,29652,8969,292,-2696.0
11096,17048,8726,1488,8524,202,0,0,1286.0
44720,109927,81034,18661,50102,30932,9723,286,-2834.0
46000,109611,78967,17858,50786,28181,8039,218,-2502.0
35645,105620,100126,29871,21026,79100,63568,14059,280.0
48127,94532,59262,12015,46434,12828,1664,9,842.0
31058,50907,27633,4972,25434,2199,39,0,2812.0
